LastStatisticsDate,StatisticsDate,DailyCases,TotalCases,TotalCasesLast14D,PerPopulation
2025-03-03,2020-02-26,1,1,1,0.08
2025-03-03,2020-02-27,0,1,1,0.08
2025-03-03,2020-02-28,0,1,1,0.08
2025-03-03,2020-02-29,0,1,1,0.08
2025-03-03,2020-03-01,0,1,1,0.08
2025-03-03,2020-03-02,1,2,2,0.15
2025-03-03,2020-03-03,0,2,2,0.15
2025-03-03,2020-03-04,1,3,3,0.23
2025-03-03,2020-03-05,7,10,10,0.75
2025-03-03,2020-03-06,0,10,10,0.75
2025-03-03,2020-03-07,0,10,10,0.75
2025-03-03,2020-03-08,0,10,10,0.75
2025-03-03,2020-03-09,3,13,13,0.98
2025-03-03,2020-03-10,2,15,15,1.13
2025-03-03,2020-03-11,3,18,17,1.28
2025-03-03,2020-03-12,40,58,57,4.29
2025-03-03,2020-03-13,43,101,100,7.52
2025-03-03,2020-03-14,23,124,123,9.26
2025-03-03,2020-03-15,75,199,198,14.9
2025-03-03,2020-03-16,25,224,222,16.7
2025-03-03,2020-03-17,22,246,244,18.36
2025-03-03,2020-03-18,28,274,271,20.39
2025-03-03,2020-03-19,28,302,292,21.97
2025-03-03,2020-03-20,13,315,305,22.95
2025-03-03,2020-03-21,41,356,346,26.04
2025-03-03,2020-03-22,13,369,359,27.01
2025-03-03,2020-03-23,24,393,380,28.59
2025-03-03,2020-03-24,74,467,452,34.01
2025-03-03,2020-03-25,55,522,504,37.92
2025-03-03,2020-03-26,37,559,501,37.7
2025-03-03,2020-03-27,64,623,522,39.28
2025-03-03,2020-03-28,40,663,539,40.56
2025-03-03,2020-03-29,32,695,496,37.32
2025-03-03,2020-03-30,31,726,502,37.77
2025-03-03,2020-03-31,57,783,537,40.41
2025-03-03,2020-04-01,79,862,588,44.24
2025-03-03,2020-04-02,93,955,653,49.14
2025-03-03,2020-04-03,74,1029,714,53.73
2025-03-03,2020-04-04,63,1092,736,55.38
2025-03-03,2020-04-05,11,1103,734,55.23
2025-03-03,2020-04-06,42,1145,752,56.58
2025-03-03,2020-04-07,36,1181,714,53.73
2025-03-03,2020-04-08,23,1204,682,51.32
2025-03-03,2020-04-09,51,1255,696,52.37
2025-03-03,2020-04-10,46,1301,678,51.02
2025-03-03,2020-04-11,5,1306,643,48.38
2025-03-03,2020-04-12,17,1323,628,47.25
2025-03-03,2020-04-13,45,1368,642,48.31
2025-03-03,2020-04-14,27,1395,612,46.05
2025-03-03,2020-04-15,34,1429,567,42.66
2025-03-03,2020-04-16,25,1454,499,37.55
2025-03-03,2020-04-17,53,1507,478,35.97
2025-03-03,2020-04-18,16,1523,431,32.43
2025-03-03,2020-04-19,7,1530,427,32.13
2025-03-03,2020-04-20,17,1547,402,30.25
2025-03-03,2020-04-21,7,1554,373,28.07
2025-03-03,2020-04-22,33,1587,383,28.82
2025-03-03,2020-04-23,14,1601,346,26.04
2025-03-03,2020-04-24,29,1630,329,24.76
2025-03-03,2020-04-25,9,1639,333,25.06
2025-03-03,2020-04-26,4,1643,320,24.08
2025-03-03,2020-04-27,10,1653,285,21.45
2025-03-03,2020-04-28,9,1662,267,20.09
2025-03-03,2020-04-29,23,1685,256,19.26
2025-03-03,2020-04-30,5,1690,236,17.76
2025-03-03,2020-05-01,5,1695,188,14.15
2025-03-03,2020-05-02,1,1696,173,13.02
2025-03-03,2020-05-03,3,1699,169,12.72
2025-03-03,2020-05-04,8,1707,160,12.04
2025-03-03,2020-05-05,2,1709,155,11.66
2025-03-03,2020-05-06,7,1716,129,9.71
2025-03-03,2020-05-07,5,1721,120,9.03
2025-03-03,2020-05-08,8,1729,99,7.45
2025-03-03,2020-05-09,6,1735,96,7.22
2025-03-03,2020-05-10,2,1737,94,7.07
2025-03-03,2020-05-11,5,1742,89,6.7
2025-03-03,2020-05-12,6,1748,86,6.47
2025-03-03,2020-05-13,7,1755,70,5.27
2025-03-03,2020-05-14,8,1763,73,5.49
2025-03-03,2020-05-15,4,1767,72,5.42
2025-03-03,2020-05-16,4,1771,75,5.64
2025-03-03,2020-05-17,10,1781,82,6.17
2025-03-03,2020-05-18,6,1787,80,6.02
2025-03-03,2020-05-19,4,1791,82,6.17
2025-03-03,2020-05-20,6,1797,81,6.09
2025-03-03,2020-05-21,7,1804,83,6.25
2025-03-03,2020-05-22,14,1818,89,6.7
2025-03-03,2020-05-23,2,1820,85,6.4
2025-03-03,2020-05-24,1,1821,84,6.32
2025-03-03,2020-05-25,10,1831,89,6.7
2025-03-03,2020-05-26,6,1837,89,6.7
2025-03-03,2020-05-27,11,1848,93,7
2025-03-03,2020-05-28,9,1857,94,7.07
2025-03-03,2020-05-29,6,1863,96,7.22
2025-03-03,2020-05-30,4,1867,96,7.22
2025-03-03,2020-05-31,2,1869,88,6.62
2025-03-03,2020-06-01,0,1869,82,6.17
2025-03-03,2020-06-02,10,1879,88,6.62
2025-03-03,2020-06-03,10,1889,92,6.92
2025-03-03,2020-06-04,21,1910,106,7.98
2025-03-03,2020-06-05,22,1932,114,8.58
2025-03-03,2020-06-06,7,1939,119,8.95
2025-03-03,2020-06-07,1,1940,119,8.95
2025-03-03,2020-06-08,7,1947,116,8.73
2025-03-03,2020-06-09,11,1958,121,9.1
2025-03-03,2020-06-10,7,1965,117,8.8
2025-03-03,2020-06-11,6,1971,114,8.58
2025-03-03,2020-06-12,5,1976,113,8.5
2025-03-03,2020-06-13,0,1976,109,8.2
2025-03-03,2020-06-14,0,1976,107,8.05
2025-03-03,2020-06-15,0,1976,107,8.05
2025-03-03,2020-06-16,3,1979,100,7.52
2025-03-03,2020-06-17,1,1980,91,6.85
2025-03-03,2020-06-18,3,1983,73,5.49
2025-03-03,2020-06-19,4,1987,55,4.14
2025-03-03,2020-06-20,0,1987,48,3.61
2025-03-03,2020-06-21,0,1987,47,3.54
2025-03-03,2020-06-22,1,1988,41,3.09
2025-03-03,2020-06-23,1,1989,31,2.33
2025-03-03,2020-06-24,1,1990,25,1.88
2025-03-03,2020-06-25,2,1992,21,1.58
2025-03-03,2020-06-26,1,1993,17,1.28
2025-03-03,2020-06-27,1,1994,18,1.35
2025-03-03,2020-06-28,0,1994,18,1.35
2025-03-03,2020-06-29,2,1996,20,1.5
2025-03-03,2020-06-30,0,1996,17,1.28
2025-03-03,2020-07-01,1,1997,17,1.28
2025-03-03,2020-07-02,1,1998,15,1.13
2025-03-03,2020-07-03,2,2000,13,0.98
2025-03-03,2020-07-04,0,2000,13,0.98
2025-03-03,2020-07-05,1,2001,14,1.05
2025-03-03,2020-07-06,1,2002,14,1.05
2025-03-03,2020-07-07,9,2011,22,1.66
2025-03-03,2020-07-08,8,2019,29,2.18
2025-03-03,2020-07-09,2,2021,29,2.18
2025-03-03,2020-07-10,1,2022,29,2.18
2025-03-03,2020-07-11,0,2022,28,2.11
2025-03-03,2020-07-12,0,2022,28,2.11
2025-03-03,2020-07-13,1,2023,27,2.03
2025-03-03,2020-07-14,1,2024,28,2.11
2025-03-03,2020-07-15,0,2024,27,2.03
2025-03-03,2020-07-16,4,2028,30,2.26
2025-03-03,2020-07-17,1,2029,29,2.18
2025-03-03,2020-07-18,0,2029,29,2.18
2025-03-03,2020-07-19,0,2029,28,2.11
2025-03-03,2020-07-20,1,2030,28,2.11
2025-03-03,2020-07-21,3,2033,22,1.66
2025-03-03,2020-07-22,2,2035,16,1.2
2025-03-03,2020-07-23,1,2036,15,1.13
2025-03-03,2020-07-24,3,2039,17,1.28
2025-03-03,2020-07-25,1,2040,18,1.35
2025-03-03,2020-07-26,0,2040,18,1.35
2025-03-03,2020-07-27,4,2044,21,1.58
2025-03-03,2020-07-28,4,2048,24,1.81
2025-03-03,2020-07-29,9,2057,33,2.48
2025-03-03,2020-07-30,13,2070,42,3.16
2025-03-03,2020-07-31,8,2078,49,3.69
2025-03-03,2020-08-01,7,2085,56,4.21
2025-03-03,2020-08-02,1,2086,57,4.29
2025-03-03,2020-08-03,11,2097,67,5.04
2025-03-03,2020-08-04,22,2119,86,6.47
2025-03-03,2020-08-05,11,2130,95,7.15
2025-03-03,2020-08-06,9,2139,103,7.75
2025-03-03,2020-08-07,14,2153,114,8.58
2025-03-03,2020-08-08,4,2157,117,8.8
2025-03-03,2020-08-09,6,2163,123,9.26
2025-03-03,2020-08-10,9,2172,128,9.63
2025-03-03,2020-08-11,7,2179,131,9.86
2025-03-03,2020-08-12,0,2179,122,9.18
2025-03-03,2020-08-13,3,2182,112,8.43
2025-03-03,2020-08-14,7,2189,111,8.35
2025-03-03,2020-08-15,6,2195,110,8.28
2025-03-03,2020-08-16,2,2197,111,8.35
2025-03-03,2020-08-17,8,2205,108,8.13
2025-03-03,2020-08-18,7,2212,93,7
2025-03-03,2020-08-19,20,2232,102,7.68
2025-03-03,2020-08-20,17,2249,110,8.28
2025-03-03,2020-08-21,21,2270,117,8.8
2025-03-03,2020-08-22,7,2277,120,9.03
2025-03-03,2020-08-23,3,2280,117,8.8
2025-03-03,2020-08-24,19,2299,127,9.56
2025-03-03,2020-08-25,17,2316,137,10.31
2025-03-03,2020-08-26,14,2330,151,11.36
2025-03-03,2020-08-27,18,2348,166,12.49
2025-03-03,2020-08-28,20,2368,179,13.47
2025-03-03,2020-08-29,10,2378,183,13.77
2025-03-03,2020-08-30,2,2380,183,13.77
2025-03-03,2020-08-31,20,2400,195,14.67
2025-03-03,2020-09-01,20,2420,208,15.65
2025-03-03,2020-09-02,26,2446,214,16.1
2025-03-03,2020-09-03,16,2462,213,16.03
2025-03-03,2020-09-04,35,2497,227,17.08
2025-03-03,2020-09-05,25,2522,245,18.44
2025-03-03,2020-09-06,16,2538,258,19.41
2025-03-03,2020-09-07,32,2570,271,20.39
2025-03-03,2020-09-08,22,2592,276,20.77
2025-03-03,2020-09-09,15,2607,277,20.84
2025-03-03,2020-09-10,32,2639,291,21.9
2025-03-03,2020-09-11,23,2662,294,22.12
2025-03-03,2020-09-12,21,2683,305,22.95
2025-03-03,2020-09-13,22,2705,325,24.45
2025-03-03,2020-09-14,24,2729,329,24.76
2025-03-03,2020-09-15,34,2763,343,25.81
2025-03-03,2020-09-16,21,2784,338,25.43
2025-03-03,2020-09-17,36,2820,358,26.94
2025-03-03,2020-09-18,61,2881,384,28.89
2025-03-03,2020-09-19,49,2930,408,30.7
2025-03-03,2020-09-20,17,2947,409,30.78
2025-03-03,2020-09-21,35,2982,412,31
2025-03-03,2020-09-22,57,3039,447,33.63
2025-03-03,2020-09-23,45,3084,477,35.89
2025-03-03,2020-09-24,41,3125,486,36.57
2025-03-03,2020-09-25,47,3172,510,38.38
2025-03-03,2020-09-26,35,3207,524,39.43
2025-03-03,2020-09-27,67,3274,569,42.81
2025-03-03,2020-09-28,48,3322,593,44.62
2025-03-03,2020-09-29,56,3378,615,46.28
2025-03-03,2020-09-30,80,3458,674,50.72
2025-03-03,2020-10-01,57,3515,695,52.3
2025-03-03,2020-10-02,69,3584,703,52.9
2025-03-03,2020-10-03,30,3614,684,51.47
2025-03-03,2020-10-04,10,3624,677,50.94
2025-03-03,2020-10-05,42,3666,684,51.47
2025-03-03,2020-10-06,25,3691,652,49.06
2025-03-03,2020-10-07,76,3767,683,51.39
2025-03-03,2020-10-08,49,3816,691,51.99
2025-03-03,2020-10-09,37,3853,681,51.24
2025-03-03,2020-10-10,19,3872,665,50.04
2025-03-03,2020-10-11,18,3890,616,46.35
2025-03-03,2020-10-12,25,3915,593,44.62
2025-03-03,2020-10-13,39,3954,576,43.34
2025-03-03,2020-10-14,33,3987,529,39.81
2025-03-03,2020-10-15,37,4024,509,38.3
2025-03-03,2020-10-16,35,4059,475,35.74
2025-03-03,2020-10-17,26,4085,471,35.44
2025-03-03,2020-10-18,7,4092,468,35.22
2025-03-03,2020-10-19,42,4134,468,35.22
2025-03-03,2020-10-20,45,4179,488,36.72
2025-03-03,2020-10-21,75,4254,487,36.64
2025-03-03,2020-10-22,53,4307,491,36.95
2025-03-03,2020-10-23,52,4359,506,38.07
2025-03-03,2020-10-24,58,4417,545,41.01
2025-03-03,2020-10-25,17,4434,544,40.93
2025-03-03,2020-10-26,37,4471,556,41.84
2025-03-03,2020-10-27,126,4597,643,48.38
2025-03-03,2020-10-28,80,4677,690,51.92
2025-03-03,2020-10-29,95,4772,748,56.28
2025-03-03,2020-10-30,133,4905,846,63.66
2025-03-03,2020-10-31,81,4986,901,67.8
2025-03-03,2020-11-01,62,5048,956,71.94
2025-03-03,2020-11-02,80,5128,994,74.79
2025-03-03,2020-11-03,208,5336,1157,87.06
2025-03-03,2020-11-04,131,5467,1213,91.27
2025-03-03,2020-11-05,242,5709,1402,105.49
2025-03-03,2020-11-06,228,5937,1578,118.74
2025-03-03,2020-11-07,193,6130,1713,128.9
2025-03-03,2020-11-08,125,6255,1821,137.02
2025-03-03,2020-11-09,128,6383,1912,143.87
2025-03-03,2020-11-10,132,6515,1918,144.32
2025-03-03,2020-11-11,375,6890,2213,166.52
2025-03-03,2020-11-12,258,7148,2376,178.78
2025-03-03,2020-11-13,264,7412,2507,188.64
2025-03-03,2020-11-14,224,7636,2650,199.4
2025-03-03,2020-11-15,211,7847,2799,210.61
2025-03-03,2020-11-16,187,8034,2906,218.66
2025-03-03,2020-11-17,271,8305,2969,223.41
2025-03-03,2020-11-18,411,8716,3249,244.47
2025-03-03,2020-11-19,361,9077,3368,253.43
2025-03-03,2020-11-20,300,9377,3440,258.85
2025-03-03,2020-11-21,349,9726,3596,270.58
2025-03-03,2020-11-22,232,9958,3703,278.64
2025-03-03,2020-11-23,204,10162,3779,284.35
2025-03-03,2020-11-24,383,10545,4030,303.24
2025-03-03,2020-11-25,413,10958,4068,306.1
2025-03-03,2020-11-26,370,11328,4180,314.53
2025-03-03,2020-11-27,374,11702,4290,322.8
2025-03-03,2020-11-28,355,12057,4421,332.66
2025-03-03,2020-11-29,256,12313,4466,336.05
2025-03-03,2020-11-30,188,12501,4467,336.12
2025-03-03,2020-12-01,524,13025,4720,355.16
2025-03-03,2020-12-02,450,13475,4759,358.1
2025-03-03,2020-12-03,470,13945,4868,366.3
2025-03-03,2020-12-04,562,14507,5130,386.01
2025-03-03,2020-12-05,479,14986,5260,395.79
2025-03-03,2020-12-06,249,15235,5277,397.07
2025-03-03,2020-12-07,287,15522,5360,403.32
2025-03-03,2020-12-08,544,16066,5521,415.43
2025-03-03,2020-12-09,545,16611,5653,425.37
2025-03-03,2020-12-10,359,16970,5642,424.54
2025-03-03,2020-12-11,759,17729,6027,453.51
2025-03-03,2020-12-12,342,18071,6014,452.53
2025-03-03,2020-12-13,330,18401,6088,458.1
2025-03-03,2020-12-14,298,18699,6198,466.37
2025-03-03,2020-12-15,589,19288,6263,471.27
2025-03-03,2020-12-16,734,20022,6547,492.63
2025-03-03,2020-12-17,657,20679,6734,506.71
2025-03-03,2020-12-18,564,21243,6736,506.86
2025-03-03,2020-12-19,580,21823,6837,514.46
2025-03-03,2020-12-20,284,22107,6872,517.09
2025-03-03,2020-12-21,565,22672,7150,538.01
2025-03-03,2020-12-22,665,23337,7271,547.11
2025-03-03,2020-12-23,696,24033,7422,558.48
2025-03-03,2020-12-24,574,24607,7637,574.65
2025-03-03,2020-12-25,448,25055,7326,551.25
2025-03-03,2020-12-26,364,25419,7348,552.91
2025-03-03,2020-12-27,418,25837,7436,559.53
2025-03-03,2020-12-28,476,26313,7614,572.92
2025-03-03,2020-12-29,965,27278,7990,601.21
2025-03-03,2020-12-30,732,28010,7988,601.06
2025-03-03,2020-12-31,418,28428,7749,583.08
2025-03-03,2021-01-01,379,28807,7564,569.16
2025-03-03,2021-01-02,342,29149,7326,551.25
2025-03-03,2021-01-03,391,29540,7433,559.3
2025-03-03,2021-01-04,432,29972,7300,549.3
2025-03-03,2021-01-05,720,30692,7355,553.43
2025-03-03,2021-01-06,1085,31777,7744,582.7
2025-03-03,2021-01-07,784,32561,7954,598.51
2025-03-03,2021-01-08,554,33115,8060,606.48
2025-03-03,2021-01-09,425,33540,8121,611.07
2025-03-03,2021-01-10,290,33830,7993,601.44
2025-03-03,2021-01-11,335,34165,7852,590.83
2025-03-03,2021-01-12,856,35021,7743,582.63
2025-03-03,2021-01-13,630,35651,7641,574.95
2025-03-03,2021-01-14,453,36104,7676,577.59
2025-03-03,2021-01-15,617,36721,7914,595.5
2025-03-03,2021-01-16,388,37109,7960,598.96
2025-03-03,2021-01-17,266,37375,7835,589.55
2025-03-03,2021-01-18,600,37975,8003,602.19
2025-03-03,2021-01-19,610,38585,7893,593.92
2025-03-03,2021-01-20,669,39254,7477,562.61
2025-03-03,2021-01-21,495,39749,7188,540.87
2025-03-03,2021-01-22,484,40233,7118,535.6
2025-03-03,2021-01-23,532,40765,7225,543.65
2025-03-03,2021-01-24,257,41022,7192,541.17
2025-03-03,2021-01-25,358,41380,7215,542.9
2025-03-03,2021-01-26,639,42019,6998,526.57
2025-03-03,2021-01-27,692,42711,7060,531.24
2025-03-03,2021-01-28,692,43403,7299,549.22
2025-03-03,2021-01-29,402,43805,7084,533.04
2025-03-03,2021-01-30,468,44273,7164,539.06
2025-03-03,2021-01-31,368,44641,7266,546.74
2025-03-03,2021-02-01,412,45053,7078,532.59
2025-03-03,2021-02-02,689,45742,7157,538.53
2025-03-03,2021-02-03,672,46414,7160,538.76
2025-03-03,2021-02-04,592,47006,7257,546.06
2025-03-03,2021-02-05,590,47596,7363,554.04
2025-03-03,2021-02-06,422,48018,7253,545.76
2025-03-03,2021-02-07,342,48360,7338,552.15
2025-03-03,2021-02-08,544,48904,7524,566.15
2025-03-03,2021-02-09,802,49706,7687,578.42
2025-03-03,2021-02-10,680,50386,7675,577.51
2025-03-03,2021-02-11,714,51100,7697,579.17
2025-03-03,2021-02-12,756,51856,8051,605.8
2025-03-03,2021-02-13,670,52526,8253,621
2025-03-03,2021-02-14,414,52940,8299,624.47
2025-03-03,2021-02-15,618,53558,8505,639.97
2025-03-03,2021-02-16,817,54375,8633,649.6
2025-03-03,2021-02-17,1007,55382,8968,674.81
2025-03-03,2021-02-18,956,56338,9332,702.19
2025-03-03,2021-02-19,790,57128,9532,717.24
2025-03-03,2021-02-20,586,57714,9696,729.58
2025-03-03,2021-02-21,832,58546,10186,766.45
2025-03-03,2021-02-22,968,59514,10610,798.36
2025-03-03,2021-02-23,1072,60586,10880,818.68
2025-03-03,2021-02-24,1157,61743,11357,854.57
2025-03-03,2021-02-25,1205,62948,11848,891.51
2025-03-03,2021-02-26,1580,64528,12672,953.52
2025-03-03,2021-02-27,1203,65731,13205,993.62
2025-03-03,2021-02-28,1030,66761,13821,1039.97
2025-03-03,2021-03-01,1114,67875,14317,1077.3
2025-03-03,2021-03-02,1467,69342,14967,1126.21
2025-03-03,2021-03-03,1434,70776,15394,1158.34
2025-03-03,2021-03-04,1537,72313,15975,1202.05
2025-03-03,2021-03-05,1541,73854,16726,1258.56
2025-03-03,2021-03-06,1318,75172,17458,1313.64
2025-03-03,2021-03-07,1180,76352,17806,1339.83
2025-03-03,2021-03-08,1307,77659,18145,1365.34
2025-03-03,2021-03-09,1485,79144,18558,1396.41
2025-03-03,2021-03-10,1960,81104,19361,1456.84
2025-03-03,2021-03-11,1361,82465,19517,1468.57
2025-03-03,2021-03-12,1587,84052,19524,1469.1
2025-03-03,2021-03-13,936,84988,19257,1449.01
2025-03-03,2021-03-14,1280,86268,19507,1467.82
2025-03-03,2021-03-15,1466,87734,19859,1494.31
2025-03-03,2021-03-16,1783,89517,20175,1518.09
2025-03-03,2021-03-17,1702,91219,20443,1538.25
2025-03-03,2021-03-18,1751,92970,20657,1554.35
2025-03-03,2021-03-19,1252,94222,20368,1532.61
2025-03-03,2021-03-20,1375,95597,20425,1536.9
2025-03-03,2021-03-21,993,96590,20238,1522.83
2025-03-03,2021-03-22,1064,97654,19995,1504.54
2025-03-03,2021-03-23,1557,99211,20067,1509.96
2025-03-03,2021-03-24,1438,100649,19545,1470.68
2025-03-03,2021-03-25,1158,101807,19342,1455.41
2025-03-03,2021-03-26,1158,102965,18913,1423.13
2025-03-03,2021-03-27,896,103861,18873,1420.12
2025-03-03,2021-03-28,590,104451,18183,1368.2
2025-03-03,2021-03-29,1213,105664,17930,1349.16
2025-03-03,2021-03-30,1019,106683,17166,1291.67
2025-03-03,2021-03-31,1114,107797,16578,1247.43
2025-03-03,2021-04-01,913,108710,15740,1184.37
2025-03-03,2021-04-02,524,109234,15012,1129.59
2025-03-03,2021-04-03,490,109724,14127,1063
2025-03-03,2021-04-04,397,110121,13531,1018.15
2025-03-03,2021-04-05,922,111043,13389,1007.47
2025-03-03,2021-04-06,996,112039,12828,965.25
2025-03-03,2021-04-07,771,112810,12161,915.07
2025-03-03,2021-04-08,685,113495,11688,879.47
2025-03-03,2021-04-09,648,114143,11178,841.1
2025-03-03,2021-04-10,451,114594,10733,807.61
2025-03-03,2021-04-11,277,114871,10420,784.06
2025-03-03,2021-04-12,647,115518,9854,741.47
2025-03-03,2021-04-13,559,116077,9394,706.86
2025-03-03,2021-04-14,579,116656,8859,666.6
2025-03-03,2021-04-15,488,117144,8434,634.62
2025-03-03,2021-04-16,340,117484,8250,620.78
2025-03-03,2021-04-17,547,118031,8307,625.07
2025-03-03,2021-04-18,235,118266,8145,612.88
2025-03-03,2021-04-19,543,118809,7766,584.36
2025-03-03,2021-04-20,482,119291,7252,545.68
2025-03-03,2021-04-21,445,119736,6926,521.15
2025-03-03,2021-04-22,399,120135,6640,499.63
2025-03-03,2021-04-23,392,120527,6384,480.37
2025-03-03,2021-04-24,217,120744,6150,462.76
2025-03-03,2021-04-25,169,120913,6042,454.64
2025-03-03,2021-04-26,478,121391,5873,441.92
2025-03-03,2021-04-27,403,121794,5717,430.18
2025-03-03,2021-04-28,429,122223,5567,418.89
2025-03-03,2021-04-29,369,122592,5448,409.94
2025-03-03,2021-04-30,413,123005,5521,415.43
2025-03-03,2021-05-01,177,123182,5151,387.59
2025-03-03,2021-05-02,178,123360,5094,383.3
2025-03-03,2021-05-03,406,123766,4957,372.99
2025-03-03,2021-05-04,429,124195,4904,369.01
2025-03-03,2021-05-05,367,124562,4826,363.14
2025-03-03,2021-05-06,386,124948,4813,362.16
2025-03-03,2021-05-07,352,125300,4773,359.15
2025-03-03,2021-05-08,157,125457,4713,354.63
2025-03-03,2021-05-09,199,125656,4743,356.89
2025-03-03,2021-05-10,363,126019,4628,348.24
2025-03-03,2021-05-11,373,126392,4598,345.98
2025-03-03,2021-05-12,303,126695,4472,336.5
2025-03-03,2021-05-13,285,126980,4388,330.18
2025-03-03,2021-05-14,283,127263,4258,320.4
2025-03-03,2021-05-15,134,127397,4215,317.16
2025-03-03,2021-05-16,153,127550,4190,315.28
2025-03-03,2021-05-17,298,127848,4082,307.15
2025-03-03,2021-05-18,257,128105,3910,294.21
2025-03-03,2021-05-19,242,128347,3785,284.81
2025-03-03,2021-05-20,229,128576,3628,272.99
2025-03-03,2021-05-21,181,128757,3457,260.13
2025-03-03,2021-05-22,103,128860,3403,256.06
2025-03-03,2021-05-23,77,128937,3281,246.88
2025-03-03,2021-05-24,164,129101,3082,231.91
2025-03-03,2021-05-25,186,129287,2895,217.84
2025-03-03,2021-05-26,147,129434,2739,206.1
2025-03-03,2021-05-27,141,129575,2595,195.26
2025-03-03,2021-05-28,128,129703,2440,183.6
2025-03-03,2021-05-29,66,129769,2372,178.48
2025-03-03,2021-05-30,60,129829,2279,171.49
2025-03-03,2021-05-31,133,129962,2114,159.07
2025-03-03,2021-06-01,131,130093,1988,149.59
2025-03-03,2021-06-02,107,130200,1853,139.43
2025-03-03,2021-06-03,100,130300,1724,129.72
2025-03-03,2021-06-04,63,130363,1606,120.84
2025-03-03,2021-06-05,52,130415,1555,117.01
2025-03-03,2021-06-06,39,130454,1517,114.15
2025-03-03,2021-06-07,85,130539,1438,108.2
2025-03-03,2021-06-08,69,130608,1321,99.4
2025-03-03,2021-06-09,54,130662,1228,92.4
2025-03-03,2021-06-10,54,130716,1141,85.86
2025-03-03,2021-06-11,53,130769,1066,80.21
2025-03-03,2021-06-12,38,130807,1038,78.11
2025-03-03,2021-06-13,28,130835,1006,75.7
2025-03-03,2021-06-14,62,130897,935,70.35
2025-03-03,2021-06-15,60,130957,864,65.01
2025-03-03,2021-06-16,41,130998,798,60.05
2025-03-03,2021-06-17,56,131054,754,56.74
2025-03-03,2021-06-18,35,131089,726,54.63
2025-03-03,2021-06-19,26,131115,700,52.67
2025-03-03,2021-06-20,12,131127,673,50.64
2025-03-03,2021-06-21,37,131164,625,47.03
2025-03-03,2021-06-22,26,131190,582,43.79
2025-03-03,2021-06-23,20,131210,548,41.23
2025-03-03,2021-06-24,12,131222,506,38.07
2025-03-03,2021-06-25,34,131256,487,36.64
2025-03-03,2021-06-26,27,131283,476,35.82
2025-03-03,2021-06-27,15,131298,463,34.84
2025-03-03,2021-06-28,47,131345,448,33.71
2025-03-03,2021-06-29,37,131382,425,31.98
2025-03-03,2021-06-30,21,131403,405,30.47
2025-03-03,2021-07-01,39,131442,388,29.2
2025-03-03,2021-07-02,39,131481,392,29.5
2025-03-03,2021-07-03,27,131508,393,29.57
2025-03-03,2021-07-04,20,131528,401,30.17
2025-03-03,2021-07-05,50,131578,414,31.15
2025-03-03,2021-07-06,42,131620,430,32.36
2025-03-03,2021-07-07,58,131678,468,35.22
2025-03-03,2021-07-08,39,131717,495,37.25
2025-03-03,2021-07-09,64,131781,525,39.5
2025-03-03,2021-07-10,27,131808,525,39.5
2025-03-03,2021-07-11,22,131830,532,40.03
2025-03-03,2021-07-12,57,131887,542,40.78
2025-03-03,2021-07-13,56,131943,561,42.21
2025-03-03,2021-07-14,64,132007,604,45.45
2025-03-03,2021-07-15,62,132069,627,47.18
2025-03-03,2021-07-16,64,132133,652,49.06
2025-03-03,2021-07-17,41,132174,666,50.11
2025-03-03,2021-07-18,35,132209,681,51.24
2025-03-03,2021-07-19,81,132290,712,53.58
2025-03-03,2021-07-20,97,132387,767,57.71
2025-03-03,2021-07-21,121,132508,830,62.45
2025-03-03,2021-07-22,84,132592,875,65.84
2025-03-03,2021-07-23,106,132698,917,69
2025-03-03,2021-07-24,91,132789,981,73.82
2025-03-03,2021-07-25,67,132856,1026,77.2
2025-03-03,2021-07-26,192,133048,1161,87.36
2025-03-03,2021-07-27,173,133221,1278,96.16
2025-03-03,2021-07-28,220,133441,1434,107.9
2025-03-03,2021-07-29,181,133622,1553,116.86
2025-03-03,2021-07-30,249,133871,1738,130.78
2025-03-03,2021-07-31,127,133998,1824,137.25
2025-03-03,2021-08-01,87,134085,1876,141.16
2025-03-03,2021-08-02,221,134306,2016,151.7
2025-03-03,2021-08-03,232,134538,2151,161.85
2025-03-03,2021-08-04,258,134796,2288,172.16
2025-03-03,2021-08-05,242,135038,2446,184.05
2025-03-03,2021-08-06,242,135280,2582,194.28
2025-03-03,2021-08-07,126,135406,2617,196.92
2025-03-03,2021-08-08,146,135552,2696,202.86
2025-03-03,2021-08-09,290,135842,2794,210.24
2025-03-03,2021-08-10,343,136185,2964,223.03
2025-03-03,2021-08-11,368,136553,3112,234.17
2025-03-03,2021-08-12,281,136834,3212,241.69
2025-03-03,2021-08-13,290,137124,3253,244.77
2025-03-03,2021-08-14,203,137327,3329,250.49
2025-03-03,2021-08-15,163,137490,3405,256.21
2025-03-03,2021-08-16,358,137848,3542,266.52
2025-03-03,2021-08-17,287,138135,3597,270.66
2025-03-03,2021-08-18,357,138492,3696,278.11
2025-03-03,2021-08-19,330,138822,3784,284.73
2025-03-03,2021-08-20,218,139040,3760,282.92
2025-03-03,2021-08-21,101,139141,3735,281.04
2025-03-03,2021-08-22,318,139459,3907,293.99
2025-03-03,2021-08-23,374,139833,3991,300.31
2025-03-03,2021-08-24,437,140270,4085,307.38
2025-03-03,2021-08-25,402,140672,4119,309.94
2025-03-03,2021-08-26,351,141023,4189,315.21
2025-03-03,2021-08-27,324,141347,4223,317.76
2025-03-03,2021-08-28,330,141677,4350,327.32
2025-03-03,2021-08-29,255,141932,4442,334.24
2025-03-03,2021-08-30,359,142291,4443,334.32
2025-03-03,2021-08-31,408,142699,4564,343.42
2025-03-03,2021-09-01,474,143173,4681,352.23
2025-03-03,2021-09-02,347,143520,4698,353.51
2025-03-03,2021-09-03,353,143873,4833,363.66
2025-03-03,2021-09-04,255,144128,4987,375.25
2025-03-03,2021-09-05,211,144339,4880,367.2
2025-03-03,2021-09-06,390,144729,4896,368.4
2025-03-03,2021-09-07,486,145215,4945,372.09
2025-03-03,2021-09-08,467,145682,5010,376.98
2025-03-03,2021-09-09,540,146222,5199,391.2
2025-03-03,2021-09-10,493,146715,5368,403.92
2025-03-03,2021-09-11,329,147044,5367,403.84
2025-03-03,2021-09-12,268,147312,5380,404.82
2025-03-03,2021-09-13,472,147784,5493,413.33
2025-03-03,2021-09-14,525,148309,5610,422.13
2025-03-03,2021-09-15,510,148819,5646,424.84
2025-03-03,2021-09-16,532,149351,5831,438.76
2025-03-03,2021-09-17,391,149742,5869,441.62
2025-03-03,2021-09-18,462,150204,6076,457.19
2025-03-03,2021-09-19,366,150570,6231,468.86
2025-03-03,2021-09-20,463,151033,6304,474.35
2025-03-03,2021-09-21,689,151722,6507,489.63
2025-03-03,2021-09-22,590,152312,6630,498.88
2025-03-03,2021-09-23,546,152858,6636,499.33
2025-03-03,2021-09-24,643,153501,6786,510.62
2025-03-03,2021-09-25,464,153965,6921,520.78
2025-03-03,2021-09-26,390,154355,7043,529.96
2025-03-03,2021-09-27,796,155151,7367,554.34
2025-03-03,2021-09-28,745,155896,7587,570.89
2025-03-03,2021-09-29,791,156687,7868,592.03
2025-03-03,2021-09-30,730,157417,8066,606.93
2025-03-03,2021-10-01,741,158158,8416,633.27
2025-03-03,2021-10-02,627,158785,8581,645.69
2025-03-03,2021-10-03,540,159325,8755,658.78
2025-03-03,2021-10-04,892,160217,9184,691.06
2025-03-03,2021-10-05,1046,161263,9541,717.92
2025-03-03,2021-10-06,948,162211,9899,744.86
2025-03-03,2021-10-07,954,163165,10307,775.56
2025-03-03,2021-10-08,1067,164232,10731,807.46
2025-03-03,2021-10-09,814,165046,11081,833.8
2025-03-03,2021-10-10,724,165770,11415,858.93
2025-03-03,2021-10-11,1256,167026,11875,893.55
2025-03-03,2021-10-12,1229,168255,12359,929.96
2025-03-03,2021-10-13,1055,169310,12623,949.83
2025-03-03,2021-10-14,1277,170587,13170,990.99
2025-03-03,2021-10-15,1238,171825,13667,1028.39
2025-03-03,2021-10-16,1117,172942,14157,1065.26
2025-03-03,2021-10-17,820,173762,14437,1086.33
2025-03-03,2021-10-18,1101,174863,14646,1102.05
2025-03-03,2021-10-19,1346,176209,14946,1124.63
2025-03-03,2021-10-20,1506,177715,15504,1166.61
2025-03-03,2021-10-21,1322,179037,15872,1194.3
2025-03-03,2021-10-22,1642,180679,16447,1237.57
2025-03-03,2021-10-23,1786,182465,17419,1310.71
2025-03-03,2021-10-24,1282,183747,17977,1352.7
2025-03-03,2021-10-25,1192,184939,17913,1347.88
2025-03-03,2021-10-26,2025,186964,18709,1407.78
2025-03-03,2021-10-27,1996,188960,19650,1478.58
2025-03-03,2021-10-28,1679,190639,20052,1508.83
2025-03-03,2021-10-29,1890,192529,20704,1557.89
2025-03-03,2021-10-30,1877,194406,21464,1615.08
2025-03-03,2021-10-31,1410,195816,22054,1659.47
2025-03-03,2021-11-01,1571,197387,22524,1694.84
2025-03-03,2021-11-02,2308,199695,23486,1767.23
2025-03-03,2021-11-03,1945,201640,23925,1800.26
2025-03-03,2021-11-04,1435,203075,24038,1808.76
2025-03-03,2021-11-05,1522,204597,23918,1799.73
2025-03-03,2021-11-06,947,205544,23079,1736.6
2025-03-03,2021-11-07,789,206333,22586,1699.5
2025-03-03,2021-11-08,1087,207420,22481,1691.6
2025-03-03,2021-11-09,1354,208774,21810,1641.11
2025-03-03,2021-11-10,1181,209955,20995,1579.79
2025-03-03,2021-11-11,1040,210995,20356,1531.71
2025-03-03,2021-11-12,993,211988,19459,1464.21
2025-03-03,2021-11-13,561,212549,18143,1365.19
2025-03-03,2021-11-14,512,213061,17245,1297.62
2025-03-03,2021-11-15,871,213932,16545,1244.94
2025-03-03,2021-11-16,1021,214953,15258,1148.1
2025-03-03,2021-11-17,873,215826,14186,1067.44
2025-03-03,2021-11-18,715,216541,13466,1013.26
2025-03-03,2021-11-19,464,217005,12408,933.65
2025-03-03,2021-11-20,837,217842,12298,925.37
2025-03-03,2021-11-21,403,218245,11912,896.33
2025-03-03,2021-11-22,820,219065,11645,876.24
2025-03-03,2021-11-23,655,219720,10946,823.64
2025-03-03,2021-11-24,621,220341,10386,781.5
2025-03-03,2021-11-25,636,220977,9982,751.1
2025-03-03,2021-11-26,646,221623,9635,724.99
2025-03-03,2021-11-27,389,222012,9463,712.05
2025-03-03,2021-11-28,311,222323,9262,696.93
2025-03-03,2021-11-29,722,223045,9113,685.72
2025-03-03,2021-11-30,587,223632,8679,653.06
2025-03-03,2021-12-01,522,224154,8328,626.65
2025-03-03,2021-12-02,507,224661,8120,611
2025-03-03,2021-12-03,460,225121,8116,610.7
2025-03-03,2021-12-04,340,225461,7619,573.3
2025-03-03,2021-12-05,301,225762,7517,565.62
2025-03-03,2021-12-06,547,226309,7244,545.08
2025-03-03,2021-12-07,469,226778,7058,531.09
2025-03-03,2021-12-08,550,227328,6987,525.74
2025-03-03,2021-12-09,595,227923,6946,522.66
2025-03-03,2021-12-10,457,228380,6757,508.44
2025-03-03,2021-12-11,377,228757,6745,507.53
2025-03-03,2021-12-12,317,229074,6751,507.99
2025-03-03,2021-12-13,618,229692,6647,500.16
2025-03-03,2021-12-14,658,230350,6718,505.5
2025-03-03,2021-12-15,648,230998,6844,514.98
2025-03-03,2021-12-16,602,231600,6939,522.13
2025-03-03,2021-12-17,578,232178,7057,531.01
2025-03-03,2021-12-18,428,232606,7145,537.63
2025-03-03,2021-12-19,387,232993,7231,544.1
2025-03-03,2021-12-20,864,233857,7548,567.96
2025-03-03,2021-12-21,725,234582,7804,587.22
2025-03-03,2021-12-22,865,235447,8119,610.92
2025-03-03,2021-12-23,719,236166,8243,620.25
2025-03-03,2021-12-24,469,236635,8255,621.15
2025-03-03,2021-12-25,434,237069,8312,625.44
2025-03-03,2021-12-26,538,237607,8533,642.07
2025-03-03,2021-12-27,984,238591,8899,669.61
2025-03-03,2021-12-28,883,239474,9124,686.54
2025-03-03,2021-12-29,1386,240860,9862,742.08
2025-03-03,2021-12-30,1072,241932,10332,777.44
2025-03-03,2021-12-31,721,242653,10475,788.2
2025-03-03,2022-01-01,430,243083,10477,788.35
2025-03-03,2022-01-02,691,243774,10781,811.23
2025-03-03,2022-01-03,1508,245282,11425,859.68
2025-03-03,2022-01-04,1500,246782,12200,918
2025-03-03,2022-01-05,1655,248437,12990,977.44
2025-03-03,2022-01-06,1737,250174,14008,1054.04
2025-03-03,2022-01-07,1654,251828,15193,1143.21
2025-03-03,2022-01-08,1291,253119,16050,1207.7
2025-03-03,2022-01-09,1263,254382,16775,1262.25
2025-03-03,2022-01-10,1996,256378,17787,1338.4
2025-03-03,2022-01-11,2210,258588,19114,1438.25
2025-03-03,2022-01-12,2452,261040,20180,1518.46
2025-03-03,2022-01-13,2102,263142,21210,1595.97
2025-03-03,2022-01-14,2242,265384,22731,1710.41
2025-03-03,2022-01-15,2412,267796,24713,1859.55
2025-03-03,2022-01-16,2121,269917,26143,1967.15
2025-03-03,2022-01-17,2311,272228,26946,2027.58
2025-03-03,2022-01-18,3186,275414,28632,2154.44
2025-03-03,2022-01-19,3877,279291,30854,2321.64
2025-03-03,2022-01-20,4526,283817,33643,2531.5
2025-03-03,2022-01-21,4828,288645,36817,2770.33
2025-03-03,2022-01-22,3700,292345,39226,2951.6
2025-03-03,2022-01-23,5076,297421,43039,3238.51
2025-03-03,2022-01-24,5195,302616,46238,3479.22
2025-03-03,2022-01-25,5887,308503,49915,3755.9
2025-03-03,2022-01-26,6274,314777,53737,4043.49
2025-03-03,2022-01-27,5870,320647,57505,4327.02
2025-03-03,2022-01-28,7171,327818,62434,4697.9
2025-03-03,2022-01-29,5998,333816,66020,4967.73
2025-03-03,2022-01-30,4997,338813,68896,5184.14
2025-03-03,2022-01-31,6547,345360,73132,5502.88
2025-03-03,2022-02-01,7243,352603,77189,5808.16
2025-03-03,2022-02-02,6886,359489,80198,6034.57
2025-03-03,2022-02-03,8045,367534,83717,6299.36
2025-03-03,2022-02-04,7849,375383,86738,6526.68
2025-03-03,2022-02-05,7082,382465,90120,6781.16
2025-03-03,2022-02-06,4631,387096,89675,6747.68
2025-03-03,2022-02-07,6316,393412,90796,6832.03
2025-03-03,2022-02-08,6704,400116,91613,6893.5
2025-03-03,2022-02-09,6611,406727,91950,6918.86
2025-03-03,2022-02-10,5129,411856,91209,6863.1
2025-03-03,2022-02-11,5799,417655,89837,6759.87
2025-03-03,2022-02-12,4634,422289,88473,6657.23
2025-03-03,2022-02-13,2905,425194,86381,6499.82
2025-03-03,2022-02-14,3527,428721,83361,6272.57
2025-03-03,2022-02-15,8467,437188,84585,6364.67
2025-03-03,2022-02-16,6520,443708,84219,6337.13
2025-03-03,2022-02-17,6751,450459,82925,6239.77
2025-03-03,2022-02-18,6996,457455,82072,6175.58
2025-03-03,2022-02-19,4138,461593,79128,5954.06
2025-03-03,2022-02-20,2990,464583,77487,5830.58
2025-03-03,2022-02-21,5285,469868,76456,5753
2025-03-03,2022-02-22,6589,476457,76341,5744.35
2025-03-03,2022-02-23,4409,480866,74139,5578.66
2025-03-03,2022-02-24,5042,485908,74052,5572.11
2025-03-03,2022-02-25,4012,489920,72265,5437.65
2025-03-03,2022-02-26,4202,494122,71833,5405.14
2025-03-03,2022-02-27,2291,496413,71219,5358.94
2025-03-03,2022-02-28,4671,501084,72363,5445.02
2025-03-03,2022-03-01,5087,506171,68983,5190.69
2025-03-03,2022-03-02,3573,509744,66036,4968.94
2025-03-03,2022-03-03,3325,513069,62610,4711.15
2025-03-03,2022-03-04,3055,516124,58669,4414.6
2025-03-03,2022-03-05,1646,517770,56177,4227.09
2025-03-03,2022-03-06,1396,519166,54583,4107.15
2025-03-03,2022-03-07,3317,522483,52615,3959.06
2025-03-03,2022-03-08,2877,525360,48903,3679.75
2025-03-03,2022-03-09,2478,527838,46972,3534.45
2025-03-03,2022-03-10,2177,530015,44107,3318.87
2025-03-03,2022-03-11,1892,531907,41987,3159.35
2025-03-03,2022-03-12,1376,533283,39161,2946.7
2025-03-03,2022-03-13,929,534212,37799,2844.22
2025-03-03,2022-03-14,2716,536928,35844,2697.11
2025-03-03,2022-03-15,2144,539072,32901,2475.67
2025-03-03,2022-03-16,1752,540824,31080,2338.64
2025-03-03,2022-03-17,1521,542345,29276,2202.9
2025-03-03,2022-03-18,1372,543717,27593,2076.26
2025-03-03,2022-03-19,840,544557,26787,2015.61
2025-03-03,2022-03-20,671,545228,26062,1961.06
2025-03-03,2022-03-21,2012,547240,24757,1862.86
2025-03-03,2022-03-22,1840,549080,23720,1784.83
2025-03-03,2022-03-23,1457,550537,22699,1708.01
2025-03-03,2022-03-24,1474,552011,21996,1655.11
2025-03-03,2022-03-25,1289,553300,21393,1609.74
2025-03-03,2022-03-26,652,553952,20669,1555.26
2025-03-03,2022-03-27,577,554529,20317,1528.77
2025-03-03,2022-03-28,1462,555991,19063,1434.41
2025-03-03,2022-03-29,1418,557409,18337,1379.78
2025-03-03,2022-03-30,1174,558583,17759,1336.29
2025-03-03,2022-03-31,1025,559608,17263,1298.97
2025-03-03,2022-04-01,940,560548,16831,1266.46
2025-03-03,2022-04-02,461,561009,16452,1237.95
2025-03-03,2022-04-03,436,561445,16217,1220.26
2025-03-03,2022-04-04,1130,562575,15335,1153.9
2025-03-03,2022-04-05,1012,563587,14507,1091.59
2025-03-03,2022-04-06,903,564490,13953,1049.91
2025-03-03,2022-04-07,845,565335,13324,1002.58
2025-03-03,2022-04-08,756,566091,12791,962.47
2025-03-03,2022-04-09,350,566441,12489,939.75
2025-03-03,2022-04-10,282,566723,12194,917.55
2025-03-03,2022-04-11,919,567642,11651,876.69
2025-03-03,2022-04-12,636,568278,10869,817.85
2025-03-03,2022-04-13,634,568912,10329,777.21
2025-03-03,2022-04-14,464,569376,9768,735
2025-03-03,2022-04-15,261,569637,9089,683.91
2025-03-03,2022-04-16,286,569923,8914,670.74
2025-03-03,2022-04-17,184,570107,8662,651.78
2025-03-03,2022-04-18,696,570803,8228,619.12
2025-03-03,2022-04-19,214,571017,7430,559.08
2025-03-03,2022-04-20,818,571835,7345,552.68
2025-03-03,2022-04-21,385,572220,6885,518.07
2025-03-03,2022-04-22,362,572582,6491,488.42
2025-03-03,2022-04-23,184,572766,6325,475.93
2025-03-03,2022-04-24,152,572918,6195,466.15
2025-03-03,2022-04-25,535,573453,5811,437.25
2025-03-03,2022-04-26,375,573828,5550,417.61
2025-03-03,2022-04-27,326,574154,5242,394.44
2025-03-03,2022-04-28,294,574448,5072,381.65
2025-03-03,2022-04-29,277,574725,5088,382.85
2025-03-03,2022-04-30,142,574867,4944,372.02
2025-03-03,2022-05-01,110,574977,4870,366.45
2025-03-03,2022-05-02,560,575537,4734,356.21
2025-03-03,2022-05-03,258,575795,4778,359.52
2025-03-03,2022-05-04,258,576053,4218,317.39
2025-03-03,2022-05-05,220,576273,4053,304.97
2025-03-03,2022-05-06,186,576459,3877,291.73
2025-03-03,2022-05-07,86,576545,3779,284.35
2025-03-03,2022-05-08,33,576578,3660,275.4
2025-03-03,2022-05-09,317,576895,3442,259
2025-03-03,2022-05-10,196,577091,3263,245.53
2025-03-03,2022-05-11,185,577276,3122,234.92
2025-03-03,2022-05-12,110,577386,2938,221.07
2025-03-03,2022-05-13,198,577584,2859,215.13
2025-03-03,2022-05-14,86,577670,2803,210.91
2025-03-03,2022-05-15,108,577778,2801,210.76
2025-03-03,2022-05-16,216,577994,2457,184.88
2025-03-03,2022-05-17,160,578154,2359,177.51
2025-03-03,2022-05-18,184,578338,2285,171.94
2025-03-03,2022-05-19,129,578467,2194,165.09
2025-03-03,2022-05-20,151,578618,2159,162.46
2025-03-03,2022-05-21,70,578688,2143,161.25
2025-03-03,2022-05-22,69,578757,2179,163.96
2025-03-03,2022-05-23,145,578902,2007,151.02
2025-03-03,2022-05-24,129,579031,1940,145.98
2025-03-03,2022-05-25,157,579188,1912,143.87
2025-03-03,2022-05-26,136,579324,1938,145.83
2025-03-03,2022-05-27,127,579451,1867,140.48
2025-03-03,2022-05-28,78,579529,1859,139.88
2025-03-03,2022-05-29,60,579589,1811,136.27
2025-03-03,2022-05-30,167,579756,1762,132.58
2025-03-03,2022-05-31,150,579906,1752,131.83
2025-03-03,2022-06-01,135,580041,1703,128.14
2025-03-03,2022-06-02,124,580165,1698,127.77
2025-03-03,2022-06-03,120,580285,1667,125.43
2025-03-03,2022-06-04,57,580342,1654,124.46
2025-03-03,2022-06-05,45,580387,1630,122.65
2025-03-03,2022-06-06,167,580554,1652,124.31
2025-03-03,2022-06-07,146,580700,1669,125.59
2025-03-03,2022-06-08,151,580851,1663,125.13
2025-03-03,2022-06-09,151,581002,1678,126.26
2025-03-03,2022-06-10,126,581128,1677,126.19
2025-03-03,2022-06-11,57,581185,1656,124.61
2025-03-03,2022-06-12,45,581230,1641,123.48
2025-03-03,2022-06-13,112,581342,1586,119.34
2025-03-03,2022-06-14,162,581504,1598,120.24
2025-03-03,2022-06-15,129,581633,1592,119.79
2025-03-03,2022-06-16,170,581803,1638,123.25
2025-03-03,2022-06-17,105,581908,1623,122.12
2025-03-03,2022-06-18,98,582006,1664,125.21
2025-03-03,2022-06-19,50,582056,1669,125.59
2025-03-03,2022-06-20,152,582208,1654,124.46
2025-03-03,2022-06-21,229,582437,1737,130.7
2025-03-03,2022-06-22,180,582617,1766,132.88
2025-03-03,2022-06-23,41,582658,1656,124.61
2025-03-03,2022-06-24,51,582709,1581,118.96
2025-03-03,2022-06-25,106,582815,1630,122.65
2025-03-03,2022-06-26,48,582863,1633,122.88
2025-03-03,2022-06-27,223,583086,1744,131.23
2025-03-03,2022-06-28,270,583356,1852,139.36
2025-03-03,2022-06-29,244,583600,1967,148.01
2025-03-03,2022-06-30,230,583830,2027,152.52
2025-03-03,2022-07-01,206,584036,2128,160.12
2025-03-03,2022-07-02,104,584140,2134,160.57
2025-03-03,2022-07-03,72,584212,2156,162.23
2025-03-03,2022-07-04,218,584430,2222,167.2
2025-03-03,2022-07-05,175,584605,2168,163.13
2025-03-03,2022-07-06,235,584840,2223,167.27
2025-03-03,2022-07-07,208,585048,2390,179.84
2025-03-03,2022-07-08,177,585225,2516,189.32
2025-03-03,2022-07-09,105,585330,2515,189.24
2025-03-03,2022-07-10,46,585376,2513,189.09
2025-03-03,2022-07-11,250,585626,2540,191.12
2025-03-03,2022-07-12,272,585898,2542,191.28
2025-03-03,2022-07-13,253,586151,2551,191.95
2025-03-03,2022-07-14,282,586433,2603,195.87
2025-03-03,2022-07-15,262,586695,2659,200.08
2025-03-03,2022-07-16,149,586844,2704,203.46
2025-03-03,2022-07-17,98,586942,2730,205.42
2025-03-03,2022-07-18,314,587256,2826,212.64
2025-03-03,2022-07-19,313,587569,2964,223.03
2025-03-03,2022-07-20,289,587858,3018,227.09
2025-03-03,2022-07-21,388,588246,3198,240.64
2025-03-03,2022-07-22,332,588578,3353,252.3
2025-03-03,2022-07-23,208,588786,3456,260.05
2025-03-03,2022-07-24,154,588940,3564,268.18
2025-03-03,2022-07-25,349,589289,3663,275.63
2025-03-03,2022-07-26,371,589660,3762,283.08
2025-03-03,2022-07-27,420,590080,3929,295.64
2025-03-03,2022-07-28,376,590456,4023,302.71
2025-03-03,2022-07-29,417,590873,4178,314.38
2025-03-03,2022-07-30,192,591065,4221,317.61
2025-03-03,2022-07-31,104,591169,4227,318.06
2025-03-03,2022-08-01,434,591603,4347,327.09
2025-03-03,2022-08-02,434,592037,4468,336.2
2025-03-03,2022-08-03,377,592414,4556,342.82
2025-03-03,2022-08-04,353,592767,4521,340.19
2025-03-03,2022-08-05,315,593082,4504,338.91
2025-03-03,2022-08-06,143,593225,4439,334.02
2025-03-03,2022-08-07,181,593406,4466,336.05
2025-03-03,2022-08-08,388,593794,4505,338.98
2025-03-03,2022-08-09,352,594146,4486,337.55
2025-03-03,2022-08-10,337,594483,4403,331.31
2025-03-03,2022-08-11,296,594779,4323,325.29
2025-03-03,2022-08-12,299,595078,4205,316.41
2025-03-03,2022-08-13,171,595249,4184,314.83
2025-03-03,2022-08-14,89,595338,4169,313.7
2025-03-03,2022-08-15,308,595646,4043,304.22
2025-03-03,2022-08-16,283,595929,3892,292.86
2025-03-03,2022-08-17,254,596183,3769,283.6
2025-03-03,2022-08-18,196,596379,3612,271.79
2025-03-03,2022-08-19,229,596608,3526,265.32
2025-03-03,2022-08-20,100,596708,3483,262.08
2025-03-03,2022-08-21,56,596764,3358,252.68
2025-03-03,2022-08-22,226,596990,3196,240.49
2025-03-03,2022-08-23,216,597206,3060,230.25
2025-03-03,2022-08-24,192,597398,2915,219.34
2025-03-03,2022-08-25,170,597568,2789,209.86
2025-03-03,2022-08-26,183,597751,2673,201.13
2025-03-03,2022-08-27,81,597832,2583,194.36
2025-03-03,2022-08-28,39,597871,2533,190.6
2025-03-03,2022-08-29,195,598066,2420,182.1
2025-03-03,2022-08-30,137,598203,2274,171.11
2025-03-03,2022-08-31,137,598340,2157,162.31
2025-03-03,2022-09-01,111,598451,2072,155.91
2025-03-03,2022-09-02,137,598588,1980,148.99
2025-03-03,2022-09-03,71,598659,1951,146.8
2025-03-03,2022-09-04,33,598692,1928,145.07
2025-03-03,2022-09-05,174,598866,1876,141.16
2025-03-03,2022-09-06,175,599041,1835,138.08
2025-03-03,2022-09-07,151,599192,1794,134.99
2025-03-03,2022-09-08,131,599323,1755,132.06
2025-03-03,2022-09-09,144,599467,1716,129.12
2025-03-03,2022-09-10,92,599559,1727,129.95
2025-03-03,2022-09-11,46,599605,1734,130.48
2025-03-03,2022-09-12,227,599832,1766,132.88
2025-03-03,2022-09-13,198,600030,1827,137.47
2025-03-03,2022-09-14,175,600205,1865,140.33
2025-03-03,2022-09-15,196,600401,1950,146.73
2025-03-03,2022-09-16,189,600590,2002,150.64
2025-03-03,2022-09-17,122,600712,2053,154.48
2025-03-03,2022-09-18,81,600793,2101,158.09
2025-03-03,2022-09-19,230,601023,2157,162.31
2025-03-03,2022-09-20,192,601215,2174,163.58
2025-03-03,2022-09-21,236,601451,2259,169.98
2025-03-03,2022-09-22,186,601637,2314,174.12
2025-03-03,2022-09-23,178,601815,2348,176.68
2025-03-03,2022-09-24,89,601904,2345,176.45
2025-03-03,2022-09-25,78,601982,2377,178.86
2025-03-03,2022-09-26,240,602222,2390,179.84
2025-03-03,2022-09-27,245,602467,2437,183.37
2025-03-03,2022-09-28,214,602681,2476,186.31
2025-03-03,2022-09-29,201,602882,2481,186.69
2025-03-03,2022-09-30,213,603095,2505,188.49
2025-03-03,2022-10-01,108,603203,2491,187.44
2025-03-03,2022-10-02,94,603297,2504,188.42
2025-03-03,2022-10-03,204,603501,2478,186.46
2025-03-03,2022-10-04,241,603742,2527,190.15
2025-03-03,2022-10-05,202,603944,2493,187.59
2025-03-03,2022-10-06,190,604134,2497,187.89
2025-03-03,2022-10-07,192,604326,2511,188.94
2025-03-03,2022-10-08,95,604421,2517,189.39
2025-03-03,2022-10-09,71,604492,2510,188.87
2025-03-03,2022-10-10,212,604704,2482,186.76
2025-03-03,2022-10-11,184,604888,2421,182.17
2025-03-03,2022-10-12,166,605054,2373,178.56
2025-03-03,2022-10-13,159,605213,2331,175.4
2025-03-03,2022-10-14,159,605372,2277,171.33
2025-03-03,2022-10-15,114,605486,2283,171.79
2025-03-03,2022-10-16,68,605554,2257,169.83
2025-03-03,2022-10-17,223,605777,2276,171.26
2025-03-03,2022-10-18,196,605973,2231,167.87
2025-03-03,2022-10-19,167,606140,2196,165.24
2025-03-03,2022-10-20,151,606291,2157,162.31
2025-03-03,2022-10-21,144,606435,2109,158.69
2025-03-03,2022-10-22,118,606553,2132,160.42
2025-03-03,2022-10-23,55,606608,2116,159.22
2025-03-03,2022-10-24,183,606791,2087,157.04
2025-03-03,2022-10-25,126,606917,2029,152.67
2025-03-03,2022-10-26,111,607028,1974,148.54
2025-03-03,2022-10-27,130,607158,1945,146.35
2025-03-03,2022-10-28,85,607243,1871,140.79
2025-03-03,2022-10-29,53,607296,1810,136.2
2025-03-03,2022-10-30,42,607338,1784,134.24
2025-03-03,2022-10-31,116,607454,1677,126.19
2025-03-03,2022-11-01,81,607535,1562,117.53
2025-03-03,2022-11-02,114,607649,1509,113.55
2025-03-03,2022-11-03,76,607725,1434,107.9
2025-03-03,2022-11-04,86,607811,1376,103.54
2025-03-03,2022-11-05,37,607848,1295,97.44
2025-03-03,2022-11-06,43,607891,1283,96.54
2025-03-03,2022-11-07,111,608002,1211,91.12
2025-03-03,2022-11-08,83,608085,1168,87.89
2025-03-03,2022-11-09,83,608168,1140,85.78
2025-03-03,2022-11-10,81,608249,1091,82.09
2025-03-03,2022-11-11,58,608307,1064,80.06
2025-03-03,2022-11-12,37,608344,1048,78.86
2025-03-03,2022-11-13,37,608381,1043,78.48
2025-03-03,2022-11-14,108,608489,1035,77.88
2025-03-03,2022-11-15,83,608572,1037,78.03
2025-03-03,2022-11-16,92,608664,1015,76.37
2025-03-03,2022-11-17,71,608735,1010,76
2025-03-03,2022-11-18,72,608807,996,74.94
2025-03-03,2022-11-19,39,608846,998,75.1
2025-03-03,2022-11-20,26,608872,981,73.82
2025-03-03,2022-11-21,85,608957,955,71.86
2025-03-03,2022-11-22,87,609044,959,72.16
2025-03-03,2022-11-23,71,609115,947,71.26
2025-03-03,2022-11-24,74,609189,940,70.73
2025-03-03,2022-11-25,79,609268,961,72.31
2025-03-03,2022-11-26,34,609302,958,72.09
2025-03-03,2022-11-27,44,609346,965,72.61
2025-03-03,2022-11-28,114,609460,971,73.06
2025-03-03,2022-11-29,88,609548,976,73.44
2025-03-03,2022-11-30,76,609624,960,72.24
2025-03-03,2022-12-01,73,609697,962,72.39
2025-03-03,2022-12-02,96,609793,986,74.19
2025-03-03,2022-12-03,43,609836,990,74.49
2025-03-03,2022-12-04,46,609882,1010,76
2025-03-03,2022-12-05,110,609992,1035,77.88
2025-03-03,2022-12-06,111,610103,1059,79.69
2025-03-03,2022-12-07,109,610212,1097,82.54
2025-03-03,2022-12-08,104,610316,1127,84.8
2025-03-03,2022-12-09,89,610405,1137,85.55
2025-03-03,2022-12-10,46,610451,1149,86.46
2025-03-03,2022-12-11,53,610504,1158,87.13
2025-03-03,2022-12-12,139,610643,1183,89.02
2025-03-03,2022-12-13,138,610781,1233,92.78
2025-03-03,2022-12-14,152,610933,1309,98.5
2025-03-03,2022-12-15,156,611089,1392,104.74
2025-03-03,2022-12-16,133,611222,1429,107.53
2025-03-03,2022-12-17,45,611267,1431,107.68
2025-03-03,2022-12-18,56,611323,1441,108.43
2025-03-03,2022-12-19,140,611463,1471,110.69
2025-03-03,2022-12-20,135,611598,1495,112.49
2025-03-03,2022-12-21,100,611698,1486,111.82
2025-03-03,2022-12-22,102,611800,1484,111.66
2025-03-03,2022-12-23,89,611889,1484,111.66
2025-03-03,2022-12-24,69,611958,1507,113.4
2025-03-03,2022-12-25,46,612004,1500,112.87
2025-03-03,2022-12-26,48,612052,1409,106.02
2025-03-03,2022-12-27,130,612182,1401,105.42
2025-03-03,2022-12-28,106,612288,1355,101.96
2025-03-03,2022-12-29,78,612366,1277,96.09
2025-03-03,2022-12-30,80,612446,1224,92.1
2025-03-03,2022-12-31,44,612490,1223,92.03
2025-03-03,2023-01-01,55,612545,1222,91.95
2025-03-03,2023-01-02,74,612619,1156,86.98
2025-03-03,2023-01-03,67,612686,1088,81.87
2025-03-03,2023-01-04,87,612773,1075,80.89
2025-03-03,2023-01-05,55,612828,1028,77.35
2025-03-03,2023-01-06,54,612882,993,74.72
2025-03-03,2023-01-07,28,612910,952,71.63
2025-03-03,2023-01-08,32,612942,938,70.58
2025-03-03,2023-01-09,72,613014,962,72.39
2025-03-03,2023-01-10,63,613077,895,67.35
2025-03-03,2023-01-11,67,613144,856,64.41
2025-03-03,2023-01-12,67,613211,845,63.58
2025-03-03,2023-01-13,51,613262,816,61.4
2025-03-03,2023-01-14,24,613286,796,59.9
2025-03-03,2023-01-15,33,613319,774,58.24
2025-03-03,2023-01-16,66,613385,766,57.64
2025-03-03,2023-01-17,49,613434,748,56.28
2025-03-03,2023-01-18,47,613481,708,53.27
2025-03-03,2023-01-19,55,613536,708,53.27
2025-03-03,2023-01-20,46,613582,700,52.67
2025-03-03,2023-01-21,15,613597,687,51.69
2025-03-03,2023-01-22,22,613619,677,50.94
2025-03-03,2023-01-23,78,613697,683,51.39
2025-03-03,2023-01-24,75,613772,695,52.3
2025-03-03,2023-01-25,80,613852,708,53.27
2025-03-03,2023-01-26,59,613911,700,52.67
2025-03-03,2023-01-27,55,613966,704,52.97
2025-03-03,2023-01-28,20,613986,700,52.67
2025-03-03,2023-01-29,18,614004,685,51.54
2025-03-03,2023-01-30,63,614067,682,51.32
2025-03-03,2023-01-31,56,614123,689,51.84
2025-03-03,2023-02-01,38,614161,680,51.17
2025-03-03,2023-02-02,59,614220,684,51.47
2025-03-03,2023-02-03,45,614265,683,51.39
2025-03-03,2023-02-04,22,614287,690,51.92
2025-03-03,2023-02-05,23,614310,691,51.99
2025-03-03,2023-02-06,70,614380,683,51.39
2025-03-03,2023-02-07,48,614428,656,49.36
2025-03-03,2023-02-08,55,614483,631,47.48
2025-03-03,2023-02-09,54,614537,626,47.1
2025-03-03,2023-02-10,52,614589,623,46.88
2025-03-03,2023-02-11,21,614610,624,46.95
2025-03-03,2023-02-12,28,614638,634,47.71
2025-03-03,2023-02-13,76,614714,647,48.68
2025-03-03,2023-02-14,37,614751,628,47.25
2025-03-03,2023-02-15,47,614798,637,47.93
2025-03-03,2023-02-16,66,614864,644,48.46
2025-03-03,2023-02-17,49,614913,648,48.76
2025-03-03,2023-02-18,24,614937,650,48.91
2025-03-03,2023-02-19,23,614960,650,48.91
2025-03-03,2023-02-20,54,615014,634,47.71
2025-03-03,2023-02-21,35,615049,621,46.73
2025-03-03,2023-02-22,47,615096,613,46.13
2025-03-03,2023-02-23,41,615137,600,45.15
2025-03-03,2023-02-24,23,615160,571,42.97
2025-03-03,2023-02-25,32,615192,582,43.79
2025-03-03,2023-02-26,39,615231,593,44.62
2025-03-03,2023-02-27,57,615288,574,43.19
2025-03-03,2023-02-28,48,615336,585,44.02
2025-03-03,2023-03-01,41,615377,579,43.57
2025-03-03,2023-03-02,44,615421,557,41.91
2025-03-03,2023-03-03,55,615476,563,42.36
2025-03-03,2023-03-04,33,615509,572,43.04
2025-03-03,2023-03-05,27,615536,576,43.34
2025-03-03,2023-03-06,59,615595,581,43.72
2025-03-03,2023-03-07,55,615650,601,45.22
2025-03-03,2023-03-08,47,615697,601,45.22
2025-03-03,2023-03-09,47,615744,607,45.67
2025-03-03,2023-03-10,43,615787,627,47.18
2025-03-03,2023-03-11,30,615817,625,47.03
2025-03-03,2023-03-12,31,615848,617,46.43
2025-03-03,2023-03-13,64,615912,624,46.95
2025-03-03,2023-03-14,71,615983,647,48.68
2025-03-03,2023-03-15,59,616042,665,50.04
2025-03-03,2023-03-16,46,616088,667,50.19
2025-03-03,2023-03-17,59,616147,671,50.49
2025-03-03,2023-03-18,36,616183,674,50.72
2025-03-03,2023-03-19,28,616211,675,50.79
2025-03-03,2023-03-20,77,616288,693,52.15
2025-03-03,2023-03-21,58,616346,696,52.37
2025-03-03,2023-03-22,67,616413,716,53.88
2025-03-03,2023-03-23,47,616460,716,53.88
2025-03-03,2023-03-24,48,616508,721,54.25
2025-03-03,2023-03-25,32,616540,723,54.4
2025-03-03,2023-03-26,20,616560,712,53.58
2025-03-03,2023-03-27,78,616638,726,54.63
2025-03-03,2023-03-28,65,616703,720,54.18
2025-03-03,2023-03-29,51,616754,712,53.58
2025-03-03,2023-03-30,55,616809,721,54.25
2025-03-03,2023-03-31,49,616858,711,53.5
2025-03-03,2023-04-01,43,616901,718,54.03
2025-03-03,2023-04-02,41,616942,731,55
2025-03-03,2023-04-03,79,617021,733,55.16
2025-03-03,2023-04-04,57,617078,732,55.08
2025-03-03,2023-04-05,61,617139,726,54.63
2025-03-03,2023-04-06,76,617215,755,56.81
2025-03-03,2023-04-07,38,617253,745,56.06
2025-03-03,2023-04-08,47,617300,760,57.19
2025-03-03,2023-04-09,34,617334,774,58.24
2025-03-03,2023-04-10,73,617407,769,57.86
2025-03-03,2023-04-11,84,617491,788,59.29
2025-03-03,2023-04-12,58,617549,795,59.82
2025-03-03,2023-04-13,45,617594,785,59.07
2025-03-03,2023-04-14,54,617648,790,59.44
2025-03-03,2023-04-15,34,617682,781,58.77
2025-03-03,2023-04-16,17,617699,757,56.96
2025-03-03,2023-04-17,70,617769,748,56.28
2025-03-03,2023-04-18,50,617819,741,55.76
2025-03-03,2023-04-19,58,617877,738,55.53
2025-03-03,2023-04-20,54,617931,716,53.88
2025-03-03,2023-04-21,49,617980,727,54.7
2025-03-03,2023-04-22,18,617998,698,52.52
2025-03-03,2023-04-23,30,618028,694,52.22
2025-03-03,2023-04-24,63,618091,684,51.47
2025-03-03,2023-04-25,49,618140,649,48.83
2025-03-03,2023-04-26,58,618198,649,48.83
2025-03-03,2023-04-27,25,618223,629,47.33
2025-03-03,2023-04-28,47,618270,622,46.8
2025-03-03,2023-04-29,22,618292,610,45.9
2025-03-03,2023-04-30,20,618312,613,46.13
2025-03-03,2023-05-01,18,618330,561,42.21
2025-03-03,2023-05-02,49,618379,560,42.14
2025-03-03,2023-05-03,46,618425,548,41.23
2025-03-03,2023-05-04,23,618448,517,38.9
2025-03-03,2023-05-05,34,618482,502,37.77
2025-03-03,2023-05-06,13,618495,497,37.4
2025-03-03,2023-05-07,25,618520,492,37.02
2025-03-03,2023-05-08,36,618556,465,34.99
2025-03-03,2023-05-09,30,618586,446,33.56
2025-03-03,2023-05-10,36,618622,424,31.9
2025-03-03,2023-05-11,21,618643,420,31.6
2025-03-03,2023-05-12,20,618663,393,29.57
2025-03-03,2023-05-13,26,618689,397,29.87
2025-03-03,2023-05-14,24,618713,401,30.17
2025-03-03,2023-05-15,52,618765,435,32.73
2025-03-03,2023-05-16,23,618788,409,30.78
2025-03-03,2023-05-17,33,618821,396,29.8
2025-03-03,2023-05-18,22,618843,395,29.72
2025-03-03,2023-05-19,24,618867,385,28.97
2025-03-03,2023-05-20,11,618878,383,28.82
2025-03-03,2023-05-21,16,618894,374,28.14
2025-03-03,2023-05-22,29,618923,367,27.62
2025-03-03,2023-05-23,24,618947,361,27.16
2025-03-03,2023-05-24,26,618973,351,26.41
2025-03-03,2023-05-25,23,618996,353,26.56
2025-03-03,2023-05-26,24,619020,357,26.86
2025-03-03,2023-05-27,12,619032,343,25.81
2025-03-03,2023-05-28,11,619043,330,24.83
2025-03-03,2023-05-29,26,619069,304,22.87
2025-03-03,2023-05-30,24,619093,305,22.95
2025-03-03,2023-05-31,15,619108,287,21.6
2025-03-03,2023-06-01,21,619129,286,21.52
2025-03-03,2023-06-02,21,619150,283,21.29
2025-03-03,2023-06-03,8,619158,280,21.07
2025-03-03,2023-06-04,5,619163,269,20.24
2025-03-03,2023-06-05,18,619181,258,19.41
2025-03-03,2023-06-06,13,619194,247,18.59
2025-03-03,2023-06-07,13,619207,234,17.61
2025-03-03,2023-06-08,20,619227,231,17.38
2025-03-03,2023-06-09,18,619245,225,16.93
2025-03-03,2023-06-10,8,619253,221,16.63
2025-03-03,2023-06-11,6,619259,216,16.25
2025-03-03,2023-06-12,11,619270,201,15.12
2025-03-03,2023-06-13,13,619283,190,14.3
2025-03-03,2023-06-14,7,619290,182,13.69
2025-03-03,2023-06-15,13,619303,174,13.09
2025-03-03,2023-06-16,6,619309,159,11.96
2025-03-03,2023-06-17,6,619315,157,11.81
2025-03-03,2023-06-18,7,619322,159,11.96
2025-03-03,2023-06-19,19,619341,160,12.04
2025-03-03,2023-06-20,11,619352,158,11.89
2025-03-03,2023-06-21,6,619358,151,11.36
2025-03-03,2023-06-22,3,619361,134,10.08
2025-03-03,2023-06-23,6,619367,122,9.18
2025-03-03,2023-06-24,2,619369,116,8.73
2025-03-03,2023-06-25,4,619373,114,8.58
2025-03-03,2023-06-26,2,619375,105,7.9
2025-03-03,2023-06-27,11,619386,103,7.75
2025-03-03,2023-06-28,10,619396,106,7.98
2025-03-03,2023-06-29,3,619399,96,7.22
2025-03-03,2023-06-30,3,619402,93,7
2025-03-03,2023-07-01,5,619407,92,6.92
2025-03-03,2023-07-02,2,619409,87,6.55
2025-03-03,2023-07-03,5,619414,73,5.49
2025-03-03,2023-07-04,6,619420,68,5.12
2025-03-03,2023-07-05,4,619424,66,4.97
2025-03-03,2023-07-06,7,619431,70,5.27
2025-03-03,2023-07-07,5,619436,69,5.19
2025-03-03,2023-07-08,2,619438,69,5.19
2025-03-03,2023-07-09,2,619440,67,5.04
2025-03-03,2023-07-10,6,619446,71,5.34
2025-03-03,2023-07-11,8,619454,68,5.12
2025-03-03,2023-07-12,7,619461,65,4.89
2025-03-03,2023-07-13,5,619466,67,5.04
2025-03-03,2023-07-14,8,619474,72,5.42
2025-03-03,2023-07-15,6,619480,73,5.49
2025-03-03,2023-07-16,4,619484,75,5.64
2025-03-03,2023-07-17,12,619496,82,6.17
2025-03-03,2023-07-18,6,619502,82,6.17
2025-03-03,2023-07-19,10,619512,88,6.62
2025-03-03,2023-07-20,9,619521,90,6.77
2025-03-03,2023-07-21,3,619524,88,6.62
2025-03-03,2023-07-22,3,619527,89,6.7
2025-03-03,2023-07-23,4,619531,91,6.85
2025-03-03,2023-07-24,4,619535,89,6.7
2025-03-03,2023-07-25,2,619537,83,6.25
2025-03-03,2023-07-26,5,619542,81,6.09
2025-03-03,2023-07-27,2,619544,78,5.87
2025-03-03,2023-07-28,4,619548,74,5.57
2025-03-03,2023-07-29,0,619548,68,5.12
2025-03-03,2023-07-30,3,619551,67,5.04
2025-03-03,2023-07-31,4,619555,59,4.44
2025-03-03,2023-08-01,4,619559,57,4.29
2025-03-03,2023-08-02,4,619563,51,3.84
2025-03-03,2023-08-03,3,619566,45,3.39
2025-03-03,2023-08-04,8,619574,50,3.76
2025-03-03,2023-08-05,2,619576,49,3.69
2025-03-03,2023-08-06,2,619578,47,3.54
2025-03-03,2023-08-07,5,619583,48,3.61
2025-03-03,2023-08-08,3,619586,49,3.69
2025-03-03,2023-08-09,0,619586,44,3.31
2025-03-03,2023-08-10,2,619588,44,3.31
2025-03-03,2023-08-11,2,619590,42,3.16
2025-03-03,2023-08-12,3,619593,45,3.39
2025-03-03,2023-08-13,2,619595,44,3.31
2025-03-03,2023-08-14,3,619598,43,3.24
2025-03-03,2023-08-15,4,619602,43,3.24
2025-03-03,2023-08-16,3,619605,42,3.16
2025-03-03,2023-08-17,3,619608,42,3.16
2025-03-03,2023-08-18,6,619614,40,3.01
2025-03-03,2023-08-19,2,619616,40,3.01
2025-03-03,2023-08-20,2,619618,40,3.01
2025-03-03,2023-08-21,9,619627,44,3.31
2025-03-03,2023-08-22,4,619631,45,3.39
2025-03-03,2023-08-23,5,619636,50,3.76
2025-03-03,2023-08-24,7,619643,55,4.14
2025-03-03,2023-08-25,5,619648,58,4.36
2025-03-03,2023-08-26,2,619650,57,4.29
2025-03-03,2023-08-27,6,619656,61,4.59
2025-03-03,2023-08-28,14,619670,72,5.42
2025-03-03,2023-08-29,7,619677,75,5.64
2025-03-03,2023-08-30,5,619682,77,5.79
2025-03-03,2023-08-31,15,619697,89,6.7
2025-03-03,2023-09-01,10,619707,93,7
2025-03-03,2023-09-02,0,619707,91,6.85
2025-03-03,2023-09-03,9,619716,98,7.37
2025-03-03,2023-09-04,14,619730,103,7.75
2025-03-03,2023-09-05,6,619736,105,7.9
2025-03-03,2023-09-06,21,619757,121,9.1
2025-03-03,2023-09-07,15,619772,129,9.71
2025-03-03,2023-09-08,14,619786,138,10.38
2025-03-03,2023-09-09,9,619795,145,10.91
2025-03-03,2023-09-10,6,619801,145,10.91
2025-03-03,2023-09-11,20,619821,151,11.36
2025-03-03,2023-09-12,9,619830,153,11.51
2025-03-03,2023-09-13,15,619845,163,12.27
2025-03-03,2023-09-14,20,619865,168,12.64
2025-03-03,2023-09-15,13,619878,171,12.87
2025-03-03,2023-09-16,5,619883,176,13.24
2025-03-03,2023-09-17,8,619891,175,13.17
2025-03-03,2023-09-18,20,619911,181,13.62
2025-03-03,2023-09-19,20,619931,195,14.67
2025-03-03,2023-09-20,7,619938,181,13.62
2025-03-03,2023-09-21,11,619949,177,13.32
2025-03-03,2023-09-22,23,619972,186,14
2025-03-03,2023-09-23,13,619985,190,14.3
2025-03-03,2023-09-24,7,619992,191,14.37
2025-03-03,2023-09-25,14,620006,185,13.92
2025-03-03,2023-09-26,19,620025,195,14.67
2025-03-03,2023-09-27,27,620052,207,15.58
2025-03-03,2023-09-28,11,620063,198,14.9
2025-03-03,2023-09-29,10,620073,195,14.67
2025-03-03,2023-09-30,15,620088,205,15.43
2025-03-03,2023-10-01,12,620100,209,15.73
2025-03-03,2023-10-02,21,620121,210,15.8
2025-03-03,2023-10-03,10,620131,200,15.05
2025-03-03,2023-10-04,10,620141,203,15.27
2025-03-03,2023-10-05,17,620158,209,15.73
2025-03-03,2023-10-06,15,620173,201,15.12
2025-03-03,2023-10-07,6,620179,194,14.6
2025-03-03,2023-10-08,3,620182,190,14.3
2025-03-03,2023-10-09,13,620195,189,14.22
2025-03-03,2023-10-10,17,620212,187,14.07
2025-03-03,2023-10-11,22,620234,182,13.69
2025-03-03,2023-10-12,16,620250,187,14.07
2025-03-03,2023-10-13,15,620265,192,14.45
2025-03-03,2023-10-14,6,620271,183,13.77
2025-03-03,2023-10-15,13,620284,184,13.85
2025-03-03,2023-10-16,21,620305,184,13.85
2025-03-03,2023-10-17,26,620331,200,15.05
2025-03-03,2023-10-18,24,620355,214,16.1
2025-03-03,2023-10-19,23,620378,220,16.55
2025-03-03,2023-10-20,30,620408,235,17.68
2025-03-03,2023-10-21,20,620428,249,18.74
2025-03-03,2023-10-22,14,620442,260,19.56
2025-03-03,2023-10-23,49,620491,296,22.27
2025-03-03,2023-10-24,28,620519,307,23.1
2025-03-03,2023-10-25,33,620552,318,23.93
2025-03-03,2023-10-26,53,620605,355,26.71
2025-03-03,2023-10-27,54,620659,394,29.65
2025-03-03,2023-10-28,31,620690,419,31.53
2025-03-03,2023-10-29,25,620715,431,32.43
2025-03-03,2023-10-30,92,620807,502,37.77
2025-03-03,2023-10-31,64,620871,540,40.63
2025-03-03,2023-11-01,57,620928,573,43.12
2025-03-03,2023-11-02,71,620999,621,46.73
2025-03-03,2023-11-03,56,621055,647,48.68
2025-03-03,2023-11-04,36,621091,663,49.89
2025-03-03,2023-11-05,51,621142,700,52.67
2025-03-03,2023-11-06,112,621254,763,57.41
2025-03-03,2023-11-07,72,621326,807,60.72
2025-03-03,2023-11-08,53,621379,827,62.23
2025-03-03,2023-11-09,83,621462,857,64.49
2025-03-03,2023-11-10,90,621552,893,67.19
2025-03-03,2023-11-11,21,621573,883,66.44
2025-03-03,2023-11-12,43,621616,901,67.8
2025-03-03,2023-11-13,98,621714,907,68.25
2025-03-03,2023-11-14,107,621821,950,71.48
2025-03-03,2023-11-15,76,621897,969,72.91
2025-03-03,2023-11-16,76,621973,974,73.29
2025-03-03,2023-11-17,86,622059,1004,75.55
2025-03-03,2023-11-18,41,622100,1009,75.92
2025-03-03,2023-11-19,45,622145,1003,75.47
2025-03-03,2023-11-20,107,622252,998,75.1
2025-03-03,2023-11-21,84,622336,1010,76
2025-03-03,2023-11-22,87,622423,1044,78.56
2025-03-03,2023-11-23,98,622521,1059,79.69
2025-03-03,2023-11-24,99,622620,1068,80.36
2025-03-03,2023-11-25,58,622678,1105,83.15
2025-03-03,2023-11-26,58,622736,1120,84.28
2025-03-03,2023-11-27,149,622885,1171,88.11
2025-03-03,2023-11-28,134,623019,1198,90.14
2025-03-03,2023-11-29,101,623120,1223,92.03
2025-03-03,2023-11-30,104,623224,1251,94.13
2025-03-03,2023-12-01,97,623321,1262,94.96
2025-03-03,2023-12-02,48,623369,1269,95.49
2025-03-03,2023-12-03,73,623442,1297,97.59
2025-03-03,2023-12-04,171,623613,1361,102.41
2025-03-03,2023-12-05,119,623732,1396,105.04
2025-03-03,2023-12-06,104,623836,1413,106.32
2025-03-03,2023-12-07,127,623963,1442,108.5
2025-03-03,2023-12-08,86,624049,1429,107.53
2025-03-03,2023-12-09,58,624107,1429,107.53
2025-03-03,2023-12-10,79,624186,1450,109.11
2025-03-03,2023-12-11,161,624347,1462,110.01
2025-03-03,2023-12-12,148,624495,1476,111.06
2025-03-03,2023-12-13,121,624616,1496,112.57
2025-03-03,2023-12-14,99,624715,1491,112.19
2025-03-03,2023-12-15,113,624828,1507,113.4
2025-03-03,2023-12-16,73,624901,1532,115.28
2025-03-03,2023-12-17,93,624994,1552,116.78
2025-03-03,2023-12-18,166,625160,1547,116.41
2025-03-03,2023-12-19,114,625274,1542,116.03
2025-03-03,2023-12-20,139,625413,1577,118.66
2025-03-03,2023-12-21,99,625512,1549,116.56
2025-03-03,2023-12-22,111,625623,1574,118.44
2025-03-03,2023-12-23,80,625703,1596,120.09
2025-03-03,2023-12-24,68,625771,1585,119.26
2025-03-03,2023-12-25,80,625851,1504,113.17
2025-03-03,2023-12-26,84,625935,1440,108.35
2025-03-03,2023-12-27,108,626043,1427,107.38
2025-03-03,2023-12-28,88,626131,1416,106.55
2025-03-03,2023-12-29,75,626206,1378,103.69
2025-03-03,2023-12-30,67,626273,1372,103.24
2025-03-03,2023-12-31,59,626332,1338,100.68
2025-03-03,2024-01-01,40,626372,1212,91.2
2025-03-03,2024-01-02,64,626436,1162,87.44
2025-03-03,2024-01-03,69,626505,1092,82.17
2025-03-03,2024-01-04,59,626564,1052,79.16
2025-03-03,2024-01-05,63,626627,1004,75.55
2025-03-03,2024-01-06,24,626651,948,71.33
2025-03-03,2024-01-07,39,626690,919,69.15
2025-03-03,2024-01-08,71,626761,910,68.47
2025-03-03,2024-01-09,42,626803,868,65.31
2025-03-03,2024-01-10,49,626852,809,60.87
2025-03-03,2024-01-11,38,626890,759,57.11
2025-03-03,2024-01-12,47,626937,731,55
2025-03-03,2024-01-13,31,626968,695,52.3
2025-03-03,2024-01-14,41,627009,677,50.94
2025-03-03,2024-01-15,60,627069,697,52.45
2025-03-03,2024-01-16,41,627110,674,50.72
2025-03-03,2024-01-17,36,627146,641,48.23
2025-03-03,2024-01-18,42,627188,624,46.95
2025-03-03,2024-01-19,38,627226,599,45.07
2025-03-03,2024-01-20,22,627248,597,44.92
2025-03-03,2024-01-21,22,627270,580,43.64
2025-03-03,2024-01-22,38,627308,547,41.16
2025-03-03,2024-01-23,32,627340,537,40.41
2025-03-03,2024-01-24,25,627365,513,38.6
2025-03-03,2024-01-25,16,627381,491,36.95
2025-03-03,2024-01-26,36,627417,480,36.12
2025-03-03,2024-01-27,18,627435,467,35.14
2025-03-03,2024-01-28,18,627453,444,33.41
2025-03-03,2024-01-29,34,627487,418,31.45
2025-03-03,2024-01-30,14,627501,391,29.42
2025-03-03,2024-01-31,16,627517,371,27.92
2025-03-03,2024-02-01,16,627533,345,25.96
2025-03-03,2024-02-02,20,627553,327,24.61
2025-03-03,2024-02-03,16,627569,321,24.15
2025-03-03,2024-02-04,10,627579,309,23.25
2025-03-03,2024-02-05,24,627603,295,22.2
2025-03-03,2024-02-06,16,627619,279,20.99
2025-03-03,2024-02-07,11,627630,265,19.94
2025-03-03,2024-02-08,16,627646,265,19.94
2025-03-03,2024-02-09,15,627661,244,18.36
2025-03-03,2024-02-10,6,627667,232,17.46
2025-03-03,2024-02-11,9,627676,223,16.78
2025-03-03,2024-02-12,15,627691,204,15.35
2025-03-03,2024-02-13,9,627700,199,14.97
2025-03-03,2024-02-14,6,627706,189,14.22
2025-03-03,2024-02-15,7,627713,180,13.54
2025-03-03,2024-02-16,15,627728,175,13.17
2025-03-03,2024-02-17,5,627733,164,12.34
2025-03-03,2024-02-18,10,627743,164,12.34
2025-03-03,2024-02-19,12,627755,152,11.44
2025-03-03,2024-02-20,18,627773,154,11.59
2025-03-03,2024-02-21,16,627789,159,11.96
2025-03-03,2024-02-22,9,627798,152,11.44
2025-03-03,2024-02-23,11,627809,148,11.14
2025-03-03,2024-02-24,4,627813,146,10.99
2025-03-03,2024-02-25,7,627820,144,10.84
2025-03-03,2024-02-26,10,627830,139,10.46
2025-03-03,2024-02-27,14,627844,144,10.84
2025-03-03,2024-02-28,6,627850,144,10.84
2025-03-03,2024-02-29,3,627853,140,10.53
2025-03-03,2024-03-01,11,627864,136,10.23
2025-03-03,2024-03-02,5,627869,136,10.23
2025-03-03,2024-03-03,6,627875,132,9.93
2025-03-03,2024-03-04,9,627884,129,9.71
2025-03-03,2024-03-05,8,627892,119,8.95
2025-03-03,2024-03-06,7,627899,110,8.28
2025-03-03,2024-03-07,7,627906,108,8.13
2025-03-03,2024-03-08,8,627914,105,7.9
2025-03-03,2024-03-09,7,627921,108,8.13
2025-03-03,2024-03-10,6,627927,107,8.05
2025-03-03,2024-03-11,9,627936,106,7.98
2025-03-03,2024-03-12,11,627947,103,7.75
2025-03-03,2024-03-13,5,627952,102,7.68
2025-03-03,2024-03-14,11,627963,110,8.28
2025-03-03,2024-03-15,6,627969,105,7.9
2025-03-03,2024-03-16,4,627973,104,7.83
2025-03-03,2024-03-17,3,627976,101,7.6
2025-03-03,2024-03-18,6,627982,98,7.37
2025-03-03,2024-03-19,6,627988,96,7.22
2025-03-03,2024-03-20,5,627993,94,7.07
2025-03-03,2024-03-21,4,627997,91,6.85
2025-03-03,2024-03-22,3,628000,86,6.47
2025-03-03,2024-03-23,4,628004,83,6.25
2025-03-03,2024-03-24,2,628006,79,5.94
2025-03-03,2024-03-25,10,628016,80,6.02
2025-03-03,2024-03-26,4,628020,73,5.49
2025-03-03,2024-03-27,10,628030,78,5.87
2025-03-03,2024-03-28,3,628033,70,5.27
2025-03-03,2024-03-29,4,628037,68,5.12
2025-03-03,2024-03-30,5,628042,69,5.19
2025-03-03,2024-03-31,2,628044,68,5.12
2025-03-03,2024-04-01,9,628053,71,5.34
2025-03-03,2024-04-02,6,628059,71,5.34
2025-03-03,2024-04-03,3,628062,69,5.19
2025-03-03,2024-04-04,4,628066,69,5.19
2025-03-03,2024-04-05,0,628066,66,4.97
2025-03-03,2024-04-06,3,628069,65,4.89
2025-03-03,2024-04-07,1,628070,64,4.82
2025-03-03,2024-04-08,2,628072,56,4.21
2025-03-03,2024-04-09,2,628074,54,4.06
2025-03-03,2024-04-10,0,628074,44,3.31
2025-03-03,2024-04-11,2,628076,43,3.24
2025-03-03,2024-04-12,2,628078,41,3.09
2025-03-03,2024-04-13,0,628078,36,2.71
2025-03-03,2024-04-14,0,628078,34,2.56
2025-03-03,2024-04-15,1,628079,26,1.96
2025-03-03,2024-04-16,3,628082,23,1.73
2025-03-03,2024-04-17,0,628082,20,1.5
2025-03-03,2024-04-18,0,628082,16,1.2
2025-03-03,2024-04-19,0,628082,16,1.2
2025-03-03,2024-04-20,0,628082,13,0.98
2025-03-03,2024-04-21,3,628085,15,1.13
2025-03-03,2024-04-22,3,628088,16,1.2
2025-03-03,2024-04-23,2,628090,16,1.2
2025-03-03,2024-04-24,1,628091,17,1.28
2025-03-03,2024-04-25,1,628092,16,1.2
2025-03-03,2024-04-26,0,628092,14,1.05
2025-03-03,2024-04-27,3,628095,17,1.28
2025-03-03,2024-04-28,1,628096,18,1.35
2025-03-03,2024-04-29,0,628096,17,1.28
2025-03-03,2024-04-30,5,628101,19,1.43
2025-03-03,2024-05-01,6,628107,25,1.88
2025-03-03,2024-05-02,2,628109,27,2.03
2025-03-03,2024-05-03,3,628112,30,2.26
2025-03-03,2024-05-04,2,628114,32,2.41
2025-03-03,2024-05-05,2,628116,31,2.33
2025-03-03,2024-05-06,5,628121,33,2.48
2025-03-03,2024-05-07,5,628126,36,2.71
2025-03-03,2024-05-08,1,628127,36,2.71
2025-03-03,2024-05-09,6,628133,41,3.09
2025-03-03,2024-05-10,3,628136,44,3.31
2025-03-03,2024-05-11,2,628138,43,3.24
2025-03-03,2024-05-12,3,628141,45,3.39
2025-03-03,2024-05-13,5,628146,50,3.76
2025-03-03,2024-05-14,2,628148,47,3.54
2025-03-03,2024-05-15,7,628155,48,3.61
2025-03-03,2024-05-16,11,628166,57,4.29
2025-03-03,2024-05-17,7,628173,61,4.59
2025-03-03,2024-05-18,3,628176,62,4.67
2025-03-03,2024-05-19,1,628177,61,4.59
2025-03-03,2024-05-20,3,628180,59,4.44
2025-03-03,2024-05-21,3,628183,57,4.29
2025-03-03,2024-05-22,1,628184,57,4.29
2025-03-03,2024-05-23,2,628186,53,3.99
2025-03-03,2024-05-24,3,628189,53,3.99
2025-03-03,2024-05-25,4,628193,55,4.14
2025-03-03,2024-05-26,6,628199,58,4.36
2025-03-03,2024-05-27,2,628201,55,4.14
2025-03-03,2024-05-28,2,628203,55,4.14
2025-03-03,2024-05-29,3,628206,51,3.84
2025-03-03,2024-05-30,8,628214,48,3.61
2025-03-03,2024-05-31,23,628237,64,4.82
2025-03-03,2024-06-01,3,628240,64,4.82
2025-03-03,2024-06-02,3,628243,66,4.97
2025-03-03,2024-06-03,2,628245,65,4.89
2025-03-03,2024-06-04,1,628246,63,4.74
2025-03-03,2024-06-05,3,628249,65,4.89
2025-03-03,2024-06-06,3,628252,66,4.97
2025-03-03,2024-06-07,2,628254,65,4.89
2025-03-03,2024-06-08,2,628256,63,4.74
2025-03-03,2024-06-09,3,628259,60,4.51
2025-03-03,2024-06-10,2,628261,60,4.51
2025-03-03,2024-06-11,2,628263,60,4.51
2025-03-03,2024-06-12,2,628265,59,4.44
2025-03-03,2024-06-13,2,628267,53,3.99
2025-03-03,2024-06-14,4,628271,34,2.56
2025-03-03,2024-06-15,3,628274,34,2.56
2025-03-03,2024-06-16,1,628275,32,2.41
2025-03-03,2024-06-17,2,628277,32,2.41
2025-03-03,2024-06-18,1,628278,32,2.41
2025-03-03,2024-06-19,6,628284,35,2.63
2025-03-03,2024-06-20,1,628285,33,2.48
2025-03-03,2024-06-21,1,628286,32,2.41
2025-03-03,2024-06-22,2,628288,32,2.41
2025-03-03,2024-06-23,2,628290,31,2.33
2025-03-03,2024-06-24,3,628293,32,2.41
2025-03-03,2024-06-25,17,628310,47,3.54
2025-03-03,2024-06-26,5,628315,50,3.76
2025-03-03,2024-06-27,2,628317,50,3.76
2025-03-03,2024-06-28,3,628320,49,3.69
2025-03-03,2024-06-29,7,628327,53,3.99
2025-03-03,2024-06-30,3,628330,55,4.14
2025-03-03,2024-07-01,4,628334,57,4.29
2025-03-03,2024-07-02,3,628337,59,4.44
2025-03-03,2024-07-03,4,628341,57,4.29
2025-03-03,2024-07-04,2,628343,58,4.36
2025-03-03,2024-07-05,6,628349,63,4.74
2025-03-03,2024-07-06,2,628351,63,4.74
2025-03-03,2024-07-07,6,628357,67,5.04
2025-03-03,2024-07-08,5,628362,69,5.19
2025-03-03,2024-07-09,10,628372,62,4.67
2025-03-03,2024-07-10,7,628379,64,4.82
2025-03-03,2024-07-11,3,628382,65,4.89
2025-03-03,2024-07-12,6,628388,68,5.12
2025-03-03,2024-07-13,8,628396,69,5.19
2025-03-03,2024-07-14,4,628400,70,5.27
2025-03-03,2024-07-15,31,628431,97,7.3
2025-03-03,2024-07-16,6,628437,100,7.52
2025-03-03,2024-07-17,5,628442,101,7.6
2025-03-03,2024-07-18,6,628448,105,7.9
2025-03-03,2024-07-19,12,628460,111,8.35
2025-03-03,2024-07-20,7,628467,116,8.73
2025-03-03,2024-07-21,11,628478,121,9.1
2025-03-03,2024-07-22,12,628490,128,9.63
2025-03-03,2024-07-23,16,628506,134,10.08
2025-03-03,2024-07-24,8,628514,135,10.16
2025-03-03,2024-07-25,7,628521,139,10.46
2025-03-03,2024-07-26,9,628530,142,10.68
2025-03-03,2024-07-27,5,628535,139,10.46
2025-03-03,2024-07-28,8,628543,143,10.76
2025-03-03,2024-07-29,15,628558,127,9.56
2025-03-03,2024-07-30,19,628577,140,10.53
2025-03-03,2024-07-31,10,628587,145,10.91
2025-03-03,2024-08-01,8,628595,147,11.06
2025-03-03,2024-08-02,8,628603,143,10.76
2025-03-03,2024-08-03,7,628610,143,10.76
2025-03-03,2024-08-04,12,628622,144,10.84
2025-03-03,2024-08-05,15,628637,147,11.06
2025-03-03,2024-08-06,19,628656,150,11.29
2025-03-03,2024-08-07,20,628676,162,12.19
2025-03-03,2024-08-08,18,628694,173,13.02
2025-03-03,2024-08-09,15,628709,179,13.47
2025-03-03,2024-08-10,18,628727,192,14.45
2025-03-03,2024-08-11,9,628736,193,14.52
2025-03-03,2024-08-12,24,628760,202,15.2
2025-03-03,2024-08-13,21,628781,204,15.35
2025-03-03,2024-08-14,12,628793,206,15.5
2025-03-03,2024-08-15,15,628808,213,16.03
2025-03-03,2024-08-16,19,628827,224,16.86
2025-03-03,2024-08-17,12,628839,229,17.23
2025-03-03,2024-08-18,15,628854,232,17.46
2025-03-03,2024-08-19,23,628877,240,18.06
2025-03-03,2024-08-20,14,628891,235,17.68
2025-03-03,2024-08-21,16,628907,231,17.38
2025-03-03,2024-08-22,25,628932,238,17.91
2025-03-03,2024-08-23,17,628949,240,18.06
2025-03-03,2024-08-24,19,628968,241,18.13
2025-03-03,2024-08-25,27,628995,259,19.49
2025-03-03,2024-08-26,25,629020,260,19.56
2025-03-03,2024-08-27,19,629039,258,19.41
2025-03-03,2024-08-28,14,629053,260,19.56
2025-03-03,2024-08-29,15,629068,260,19.56
2025-03-03,2024-08-30,21,629089,262,19.71
2025-03-03,2024-08-31,18,629107,268,20.17
2025-03-03,2024-09-01,13,629120,266,20.02
2025-03-03,2024-09-02,21,629141,264,19.86
2025-03-03,2024-09-03,14,629155,264,19.86
2025-03-03,2024-09-04,18,629173,266,20.02
2025-03-03,2024-09-05,22,629195,263,19.79
2025-03-03,2024-09-06,18,629213,264,19.86
2025-03-03,2024-09-07,13,629226,258,19.41
2025-03-03,2024-09-08,13,629239,244,18.36
2025-03-03,2024-09-09,23,629262,242,18.21
2025-03-03,2024-09-10,19,629281,242,18.21
2025-03-03,2024-09-11,14,629295,242,18.21
2025-03-03,2024-09-12,18,629313,245,18.44
2025-03-03,2024-09-13,27,629340,251,18.89
2025-03-03,2024-09-14,14,629354,247,18.59
2025-03-03,2024-09-15,24,629378,258,19.41
2025-03-03,2024-09-16,24,629402,261,19.64
2025-03-03,2024-09-17,22,629424,269,20.24
2025-03-03,2024-09-18,15,629439,266,20.02
2025-03-03,2024-09-19,15,629454,259,19.49
2025-03-03,2024-09-20,16,629470,257,19.34
2025-03-03,2024-09-21,15,629485,259,19.49
2025-03-03,2024-09-22,13,629498,259,19.49
2025-03-03,2024-09-23,20,629518,256,19.26
2025-03-03,2024-09-24,12,629530,249,18.74
2025-03-03,2024-09-25,12,629542,247,18.59
2025-03-03,2024-09-26,18,629560,247,18.59
2025-03-03,2024-09-27,14,629574,234,17.61
2025-03-03,2024-09-28,8,629582,228,17.16
2025-03-03,2024-09-29,10,629592,214,16.1
2025-03-03,2024-09-30,21,629613,211,15.88
2025-03-03,2024-10-01,12,629625,201,15.12
2025-03-03,2024-10-02,23,629648,209,15.73
2025-03-03,2024-10-03,22,629670,216,16.25
2025-03-03,2024-10-04,26,629696,226,17.01
2025-03-03,2024-10-05,25,629721,236,17.76
2025-03-03,2024-10-06,17,629738,240,18.06
2025-03-03,2024-10-07,19,629757,239,17.98
2025-03-03,2024-10-08,21,629778,248,18.66
2025-03-03,2024-10-09,16,629794,252,18.96
2025-03-03,2024-10-10,19,629813,253,19.04
2025-03-03,2024-10-11,26,629839,265,19.94
2025-03-03,2024-10-12,11,629850,268,20.17
2025-03-03,2024-10-13,18,629868,276,20.77
2025-03-03,2024-10-14,27,629895,282,21.22
2025-03-03,2024-10-15,26,629921,296,22.27
2025-03-03,2024-10-16,18,629939,291,21.9
2025-03-03,2024-10-17,14,629953,283,21.29
2025-03-03,2024-10-18,27,629980,284,21.37
2025-03-03,2024-10-19,12,629992,271,20.39
2025-03-03,2024-10-20,27,630019,281,21.14
2025-03-03,2024-10-21,24,630043,286,21.52
2025-03-03,2024-10-22,36,630079,301,22.65
2025-03-03,2024-10-23,30,630109,315,23.7
2025-03-03,2024-10-24,18,630127,314,23.63
2025-03-03,2024-10-25,22,630149,310,23.33
2025-03-03,2024-10-26,15,630164,314,23.63
2025-03-03,2024-10-27,12,630176,308,23.18
2025-03-03,2024-10-28,22,630198,303,22.8
2025-03-03,2024-10-29,25,630223,302,22.72
2025-03-03,2024-10-30,17,630240,301,22.65
2025-03-03,2024-10-31,20,630260,307,23.1
2025-03-03,2024-11-01,19,630279,299,22.5
2025-03-03,2024-11-02,11,630290,298,22.42
2025-03-03,2024-11-03,12,630302,283,21.29
2025-03-03,2024-11-04,29,630331,288,21.67
2025-03-03,2024-11-05,28,630359,280,21.07
2025-03-03,2024-11-06,14,630373,264,19.86
2025-03-03,2024-11-07,23,630396,269,20.24
2025-03-03,2024-11-08,26,630422,273,20.54
2025-03-03,2024-11-09,12,630434,270,20.32
2025-03-03,2024-11-10,21,630455,279,20.99
2025-03-03,2024-11-11,35,630490,292,21.97
2025-03-03,2024-11-12,23,630513,290,21.82
2025-03-03,2024-11-13,17,630530,290,21.82
2025-03-03,2024-11-14,19,630549,289,21.75
2025-03-03,2024-11-15,17,630566,287,21.6
2025-03-03,2024-11-16,8,630574,284,21.37
2025-03-03,2024-11-17,14,630588,286,21.52
2025-03-03,2024-11-18,28,630616,285,21.45
2025-03-03,2024-11-19,11,630627,268,20.17
2025-03-03,2024-11-20,9,630636,263,19.79
2025-03-03,2024-11-21,18,630654,258,19.41
2025-03-03,2024-11-22,16,630670,248,18.66
2025-03-03,2024-11-23,15,630685,251,18.89
2025-03-03,2024-11-24,15,630700,245,18.44
2025-03-03,2024-11-25,23,630723,233,17.53
2025-03-03,2024-11-26,13,630736,223,16.78
2025-03-03,2024-11-27,19,630755,225,16.93
2025-03-03,2024-11-28,22,630777,228,17.16
2025-03-03,2024-11-29,19,630796,230,17.31
2025-03-03,2024-11-30,18,630814,240,18.06
2025-03-03,2024-12-01,23,630837,249,18.74
2025-03-03,2024-12-02,36,630873,257,19.34
2025-03-03,2024-12-03,26,630899,272,20.47
2025-03-03,2024-12-04,19,630918,282,21.22
2025-03-03,2024-12-05,21,630939,285,21.45
2025-03-03,2024-12-06,34,630973,303,22.8
2025-03-03,2024-12-07,16,630989,304,22.87
2025-03-03,2024-12-08,23,631012,312,23.48
2025-03-03,2024-12-09,49,631061,338,25.43
2025-03-03,2024-12-10,33,631094,358,26.94
2025-03-03,2024-12-11,42,631136,381,28.67
2025-03-03,2024-12-12,46,631182,405,30.47
2025-03-03,2024-12-13,23,631205,409,30.78
2025-03-03,2024-12-14,29,631234,420,31.6
2025-03-03,2024-12-15,21,631255,418,31.45
2025-03-03,2024-12-16,41,631296,423,31.83
2025-03-03,2024-12-17,35,631331,432,32.51
2025-03-03,2024-12-18,25,631356,438,32.96
2025-03-03,2024-12-19,25,631381,442,33.26
2025-03-03,2024-12-20,39,631420,447,33.63
2025-03-03,2024-12-21,13,631433,444,33.41
2025-03-03,2024-12-22,27,631460,448,33.71
2025-03-03,2024-12-23,42,631502,441,33.18
2025-03-03,2024-12-24,22,631524,430,32.36
2025-03-03,2024-12-25,28,631552,416,31.3
2025-03-03,2024-12-26,31,631583,401,30.17
2025-03-03,2024-12-27,35,631618,413,31.08
2025-03-03,2024-12-28,21,631639,405,30.47
2025-03-03,2024-12-29,24,631663,408,30.7
2025-03-03,2024-12-30,39,631702,406,30.55
2025-03-03,2024-12-31,29,631731,400,30.1
2025-03-03,2025-01-01,23,631754,398,29.95
2025-03-03,2025-01-02,25,631779,398,29.95
2025-03-03,2025-01-03,19,631798,378,28.44
2025-03-03,2025-01-04,16,631814,381,28.67
2025-03-03,2025-01-05,17,631831,371,27.92
2025-03-03,2025-01-06,24,631855,353,26.56
2025-03-03,2025-01-07,16,631871,347,26.11
2025-03-03,2025-01-08,19,631890,338,25.43
2025-03-03,2025-01-09,28,631918,335,25.21
2025-03-03,2025-01-10,23,631941,323,24.3
2025-03-03,2025-01-11,9,631950,311,23.4
2025-03-03,2025-01-12,26,631976,313,23.55
2025-03-03,2025-01-13,14,631990,288,21.67
2025-03-03,2025-01-14,15,632005,274,20.62
2025-03-03,2025-01-15,24,632029,275,20.69
2025-03-03,2025-01-16,13,632042,263,19.79
2025-03-03,2025-01-17,9,632051,253,19.04
2025-03-03,2025-01-18,13,632064,250,18.81
2025-03-03,2025-01-19,12,632076,245,18.44
2025-03-03,2025-01-20,19,632095,240,18.06
2025-03-03,2025-01-21,24,632119,248,18.66
2025-03-03,2025-01-22,8,632127,237,17.83
2025-03-03,2025-01-23,12,632139,221,16.63
2025-03-03,2025-01-24,17,632156,215,16.18
2025-03-03,2025-01-25,12,632168,218,16.4
2025-03-03,2025-01-26,4,632172,196,14.75
2025-03-03,2025-01-27,8,632180,190,14.3
2025-03-03,2025-01-28,12,632192,187,14.07
2025-03-03,2025-01-29,16,632208,179,13.47
2025-03-03,2025-01-30,14,632222,180,13.54
2025-03-03,2025-01-31,7,632229,178,13.39
2025-03-03,2025-02-01,11,632240,176,13.24
2025-03-03,2025-02-02,16,632256,180,13.54
2025-03-03,2025-02-03,10,632266,171,12.87
2025-03-03,2025-02-04,9,632275,156,11.74
2025-03-03,2025-02-05,7,632282,155,11.66
2025-03-03,2025-02-06,7,632289,150,11.29
2025-03-03,2025-02-07,7,632296,140,10.53
2025-03-03,2025-02-08,6,632302,134,10.08
2025-03-03,2025-02-09,7,632309,137,10.31
2025-03-03,2025-02-10,15,632324,144,10.84
2025-03-03,2025-02-11,8,632332,140,10.53
2025-03-03,2025-02-12,6,632338,130,9.78
2025-03-03,2025-02-13,8,632346,124,9.33
2025-03-03,2025-02-14,11,632357,128,9.63
2025-03-03,2025-02-15,5,632362,122,9.18
2025-03-03,2025-02-16,11,632373,117,8.8
2025-03-03,2025-02-17,12,632385,119,8.95
2025-03-03,2025-02-18,9,632394,119,8.95
2025-03-03,2025-02-19,16,632410,128,9.63
2025-03-03,2025-02-20,9,632419,130,9.78
2025-03-03,2025-02-21,10,632429,133,10.01
2025-03-03,2025-02-22,0,632429,127,9.56
2025-03-03,2025-02-23,6,632435,126,9.48
2025-03-03,2025-02-24,6,632441,117,8.8
2025-03-03,2025-02-25,4,632445,113,8.5
2025-03-03,2025-02-26,5,632450,112,8.43
2025-03-03,2025-02-27,13,632463,117,8.8
2025-03-03,2025-02-28,8,632471,114,8.58
2025-03-03,2025-03-01,1,632472,110,8.28
2025-03-03,2025-03-02,3,632475,102,7.68
2025-03-03,2025-03-03,6,632481,96,7.22
